//MAP CONVERTED BY dmm2tgm.py THIS HEADER COMMENT PREVENTS RECONVERSION, DO NOT REMOVE
"a" = (
/turf/open/space/basic,
/area/template_noop)
"b" = (
/obj/machinery/conveyor/auto{
	dir = 4;
	id = "outpost3"
	},
/obj/machinery/recycler,
/obj/effect/dummy/lighting_obj{
	light_range = 10
	},
/turf/open/floor/glass/cyan,
/area/hangar)
"e" = (
/obj/structure/railing,
/obj/effect/dummy/lighting_obj{
	light_range = 10
	},
/turf/open/floor/glass/cyan,
/area/hangar)
"f" = (
/obj/machinery/conveyor/auto/outpost{
	dir = 1
	},
/obj/effect/dummy/lighting_obj{
	light_range = 10
	},
/turf/open/floor/glass/cyan,
/area/hangar)
"i" = (
/obj/effect/landmark/outpost/hangar_crate_spawner,
/obj/machinery/conveyor/auto/outpost{
	dir = 8
	},
/turf/open/floor/glass/cyan,
/area/hangar)
"j" = (
/turf/closed/indestructible/reinforced,
/area/hangar)
"k" = (
/obj/machinery/conveyor/auto{
	dir = 5;
	id = "outpost3"
	},
/obj/effect/dummy/lighting_obj{
	light_range = 10
	},
/turf/open/floor/glass/cyan,
/area/hangar)
"l" = (
/obj/machinery/conveyor/auto{
	dir = 6;
	id = "outpost3"
	},
/obj/effect/dummy/lighting_obj{
	light_range = 10
	},
/turf/open/floor/glass/cyan,
/area/hangar)
"m" = (
/obj/structure/plasticflaps/outpost,
/obj/machinery/conveyor/auto/outpost,
/obj/effect/dummy/lighting_obj{
	light_range = 10
	},
/turf/open/floor/glass/cyan,
/area/hangar)
"o" = (
/obj/structure/railing{
	dir = 8
	},
/obj/effect/dummy/lighting_obj{
	light_range = 10
	},
/turf/open/floor/glass/cyan,
/area/hangar)
"q" = (
/obj/effect/landmark/outpost/elevator_machine,
/obj/machinery/elevator_call_button{
	pixel_y = 31;
	pixel_x = 10
	},
/turf/open/floor/glass/cyan,
/area/hangar)
"r" = (
/obj/effect/landmark/outpost/shaft_number,
/turf/open/floor/glass/cyan,
/area/hangar)
"s" = (
/obj/machinery/conveyor/auto{
	dir = 8
	},
/obj/effect/dummy/lighting_obj{
	light_range = 10
	},
/turf/open/floor/glass/cyan,
/area/hangar)
"u" = (
/obj/effect/landmark/outpost/hangar_numbers,
/turf/open/floor/glass/cyan,
/area/hangar)
"v" = (
/obj/structure/railing{
	dir = 4
	},
/obj/effect/dummy/lighting_obj{
	light_range = 10
	},
/turf/open/floor/glass/cyan,
/area/hangar)
"w" = (
/obj/structure/window/reinforced/fulltile/indestructible{
	alpha = 0
	},
/turf/open/space/basic,
/area/hangar)
"x" = (
/turf/open/floor/plasteel/elevatorshaft{
	planetary_atmos = 1
	},
/area/hangar)
"y" = (
/obj/machinery/door/airlock,
/obj/effect/landmark/outpost/elevator_machine,
/turf/open/floor/glass/cyan,
/area/hangar)
"B" = (
/obj/effect/landmark/outpost/hangar_dock,
/obj/effect/dummy/lighting_obj{
	light_range = 10
	},
/turf/open/floor/glass/cyan,
/area/hangar)
"C" = (
/obj/machinery/conveyor/auto{
	id = "outpost3";
	use_static_power = 1;
	dir = 9
	},
/obj/effect/dummy/lighting_obj{
	light_range = 10
	},
/turf/open/floor/glass/cyan,
/area/hangar)
"D" = (
/obj/effect/portal/permanent/one_way{
	id = "cargo_20x20"
	},
/obj/effect/dummy/lighting_obj{
	light_range = 10
	},
/turf/open/floor/glass/cyan,
/area/hangar)
"E" = (
/obj/effect/dummy/lighting_obj{
	light_range = 10
	},
/obj/effect/dummy/lighting_obj{
	light_range = 10
	},
/obj/effect/dummy/lighting_obj{
	light_range = 10
	},
/turf/open/floor/glass/cyan,
/area/hangar)
"L" = (
/obj/machinery/conveyor/auto/outpost{
	dir = 4
	},
/obj/effect/dummy/lighting_obj{
	light_range = 10
	},
/turf/open/floor/glass/cyan,
/area/hangar)
"N" = (
/obj/effect/dummy/lighting_obj{
	light_range = 10
	},
/obj/effect/dummy/lighting_obj{
	light_range = 10
	},
/turf/open/floor/glass/cyan,
/area/hangar)
"O" = (
/obj/machinery/conveyor/auto/outpost,
/obj/effect/dummy/lighting_obj{
	light_range = 10
	},
/turf/open/floor/glass/cyan,
/area/hangar)
"P" = (
/obj/effect/landmark/outpost/elevator,
/turf/open/floor/plasteel/elevatorshaft{
	planetary_atmos = 1
	},
/area/hangar)
"Q" = (
/turf/open/floor/glass/cyan,
/area/hangar)
"R" = (
/obj/effect/landmark/portal_exit{
	id = "cargo_20x20"
	},
/obj/machinery/conveyor/auto/outpost,
/obj/effect/dummy/lighting_obj{
	light_range = 10
	},
/turf/open/floor/glass/cyan,
/area/hangar)
"T" = (
/obj/structure/window/reinforced/fulltile/indestructible{
	alpha = 0
	},
/turf/open/space/anima,
/area/hangar)
"V" = (
/obj/machinery/conveyor/auto/outpost{
	dir = 8
	},
/obj/effect/dummy/lighting_obj{
	light_range = 10
	},
/turf/open/floor/glass/cyan,
/area/hangar)
"X" = (
/obj/effect/dummy/lighting_obj{
	light_range = 10
	},
/turf/open/floor/glass/cyan,
/area/hangar)
"Y" = (
/obj/effect/dummy/lighting_obj{
	light_range = 10
	},
/obj/effect/dummy/lighting_obj{
	light_range = 10
	},
/obj/structure/railing,
/turf/open/floor/glass/cyan,
/area/hangar)
"Z" = (
/obj/machinery/conveyor/auto{
	dir = 10
	},
/obj/effect/dummy/lighting_obj{
	light_range = 10
	},
/turf/open/floor/glass/cyan,
/area/hangar)

(1,1,1) = {"
w
w
w
a
a
a
a
a
a
a
a
a
a
a
a
a
a
a
a
a
a
a
a
a
a
a
a
a
a
a
a
a
a
a
a
a
a
a
a
a
a
a
a
a
a
a
a
a
a
a
a
a
a
a
a
a
a
a
a
a
a
a
a
a
a
a
a
a
a
a
a
a
a
a
a
"}
(2,1,1) = {"
w
D
w
a
a
a
a
a
a
a
a
a
a
a
a
a
a
a
a
a
a
a
a
a
a
a
a
a
a
a
a
a
a
a
a
a
a
a
a
a
a
a
a
a
a
a
a
a
a
a
a
a
a
a
a
a
a
a
a
a
a
a
a
a
a
a
a
a
a
a
a
a
a
a
a
"}
(3,1,1) = {"
w
i
w
a
a
a
a
a
a
a
a
a
a
a
a
a
a
a
a
a
a
a
a
a
a
a
a
a
a
a
a
a
a
a
a
a
a
a
a
a
a
a
a
a
a
a
a
a
a
a
a
a
a
a
a
a
a
a
a
a
a
a
a
a
a
a
a
a
a
a
a
a
a
a
a
"}
(4,1,1) = {"
w
w
w
a
a
a
a
a
a
a
a
a
a
a
a
a
a
a
a
a
a
a
a
a
a
a
a
a
a
a
a
a
a
a
a
a
a
a
a
a
a
a
a
a
a
a
a
a
a
a
a
a
a
a
a
a
a
a
a
a
a
a
a
a
a
a
a
a
a
a
a
a
a
a
a
"}
(5,1,1) = {"
a
a
a
a
a
a
a
a
a
a
a
a
a
a
a
a
a
a
a
a
a
a
a
a
a
a
a
a
a
a
a
a
a
a
a
a
a
a
a
a
a
a
a
a
a
a
a
a
a
a
a
a
a
a
a
a
a
a
a
a
a
a
a
a
a
a
a
a
a
a
a
a
a
a
a
"}
(6,1,1) = {"
a
a
a
a
a
a
a
a
a
a
a
a
a
a
a
a
a
a
a
a
a
a
a
a
a
a
a
a
a
a
a
a
a
a
a
a
a
a
a
a
a
a
a
a
a
a
a
a
a
a
a
a
a
a
a
a
a
a
a
a
a
a
a
a
a
a
a
a
a
a
a
a
a
a
a
"}
(7,1,1) = {"
a
a
a
a
a
a
a
a
a
a
a
a
a
a
a
a
a
a
a
a
a
a
a
a
a
a
a
a
a
a
a
a
a
a
a
a
a
a
a
a
a
a
a
a
a
a
a
a
a
a
a
a
a
a
a
a
a
a
a
a
a
a
a
a
a
a
a
a
a
a
a
a
a
a
a
"}
(8,1,1) = {"
a
a
a
a
a
a
a
a
a
a
a
a
a
a
a
a
a
a
a
a
a
a
a
a
a
a
a
a
a
a
a
a
a
a
a
a
a
a
a
a
a
a
a
a
a
a
a
a
a
a
a
a
a
a
a
a
a
a
a
a
a
a
a
a
a
a
a
a
a
a
a
a
a
a
a
"}
(9,1,1) = {"
a
a
a
a
a
a
a
a
a
a
a
a
a
a
a
w
w
w
w
w
w
w
w
w
w
w
w
w
w
w
w
w
w
w
w
w
w
w
w
w
w
w
w
w
w
w
w
w
w
w
w
w
w
w
w
w
w
w
w
w
w
w
w
w
w
w
w
w
a
a
a
a
a
a
a
"}
(10,1,1) = {"
a
a
a
a
a
a
a
a
a
a
a
a
a
a
a
w
X
X
X
X
X
X
X
X
X
X
X
X
X
X
X
X
X
X
X
X
X
X
X
X
X
X
X
X
X
X
X
X
X
X
X
X
X
X
X
X
X
X
X
X
X
X
X
X
X
X
X
w
a
a
a
a
a
a
a
"}
(11,1,1) = {"
a
a
a
a
a
a
a
a
a
w
w
w
w
w
w
w
X
X
X
X
X
X
X
X
X
X
X
X
X
X
X
N
N
N
N
X
X
X
X
X
X
X
X
X
X
X
X
X
X
X
X
X
X
X
X
X
X
X
X
X
X
X
X
X
X
X
X
w
a
a
a
a
a
a
a
"}
(12,1,1) = {"
a
a
a
a
a
a
a
a
a
T
X
X
X
X
X
X
X
X
X
X
X
X
X
X
X
X
X
X
X
N
N
X
X
X
X
X
X
X
X
X
X
X
X
X
N
X
X
X
E
X
X
X
N
X
X
X
N
X
X
X
N
X
X
X
N
X
X
w
a
a
a
a
a
a
a
"}
(13,1,1) = {"
a
a
a
a
a
a
a
a
a
T
X
O
O
L
X
X
X
X
X
N
X
X
X
X
X
X
X
X
X
N
N
N
X
X
X
X
X
X
X
X
X
X
X
X
X
X
N
N
N
N
N
X
X
X
X
X
X
X
X
X
X
X
X
X
X
X
X
w
a
a
a
a
a
a
a
"}
(14,1,1) = {"
a
a
a
a
a
a
w
w
w
T
X
V
X
L
X
X
X
X
X
X
X
X
X
X
X
X
X
X
X
X
X
X
X
X
X
X
X
N
N
N
N
X
X
X
X
X
X
X
X
X
X
X
X
X
X
X
X
X
X
X
X
X
B
X
X
X
X
w
a
a
a
a
a
a
a
"}
(15,1,1) = {"
a
a
a
a
a
a
w
R
O
m
O
V
X
L
X
X
X
X
X
N
X
X
X
X
X
X
X
X
X
X
X
X
X
X
X
X
X
X
X
X
X
X
X
X
X
X
X
X
X
X
X
X
X
X
X
X
X
X
X
X
X
X
X
X
X
X
X
w
a
a
a
a
a
a
a
"}
(16,1,1) = {"
a
a
a
a
a
a
w
w
w
w
X
V
X
L
X
X
X
X
X
N
X
X
X
X
X
X
X
X
X
X
X
X
X
X
X
X
X
X
X
X
X
X
X
X
N
X
X
X
X
X
X
X
X
X
X
X
X
X
X
X
X
X
X
X
N
X
X
w
a
a
a
a
a
a
a
"}
(17,1,1) = {"
a
a
a
a
a
a
a
a
a
w
X
V
f
f
X
X
X
X
X
N
X
X
X
X
X
X
X
X
N
N
X
X
X
X
X
X
X
X
X
X
X
X
X
X
X
X
X
X
X
X
X
X
X
N
X
X
X
X
X
X
N
X
X
X
X
X
X
w
a
a
a
a
a
a
a
"}
(18,1,1) = {"
a
a
a
a
a
a
a
a
a
w
X
X
X
X
X
X
X
X
X
X
X
X
X
X
X
X
X
N
X
X
N
X
X
X
X
X
X
X
X
X
X
X
X
X
X
X
X
X
X
X
X
X
X
X
X
X
X
X
X
X
X
X
X
X
X
X
X
w
a
a
a
a
a
a
a
"}
(19,1,1) = {"
a
a
a
a
a
a
a
a
a
w
w
w
w
w
w
w
X
X
X
X
X
X
X
X
X
X
X
X
X
X
X
N
X
X
X
X
X
X
X
X
X
X
X
X
X
X
X
X
X
X
X
X
X
X
X
X
X
X
X
X
X
X
X
N
X
X
X
w
a
a
a
a
a
a
a
"}
(20,1,1) = {"
a
a
a
a
a
a
a
a
a
a
a
a
a
a
w
w
X
X
X
X
X
X
X
X
X
X
X
X
X
X
X
X
X
X
X
X
X
X
X
X
X
X
X
X
N
X
X
X
X
X
X
X
X
X
X
X
X
X
X
X
X
X
X
X
N
X
X
w
a
a
a
a
a
a
a
"}
(21,1,1) = {"
a
a
a
a
a
a
a
a
a
j
j
j
j
j
q
Q
X
X
X
X
X
X
X
X
X
X
X
X
X
X
X
X
N
X
X
X
X
X
X
X
X
X
X
X
X
X
X
X
X
X
X
X
X
N
X
X
X
X
X
X
X
X
X
X
X
X
X
w
a
a
a
a
a
a
a
"}
(22,1,1) = {"
a
a
a
a
a
a
a
a
a
j
x
x
P
y
X
Q
X
X
X
X
X
X
X
X
X
X
X
X
X
X
X
X
X
N
X
X
X
X
X
X
X
X
X
X
X
X
X
X
X
X
X
X
N
X
X
X
X
X
X
X
X
X
X
X
X
X
X
w
a
a
a
a
a
a
a
"}
(23,1,1) = {"
a
a
a
a
a
a
a
a
a
j
x
x
x
y
Q
r
X
X
X
X
X
X
N
X
X
X
X
X
X
X
X
X
X
N
X
X
X
X
X
X
X
X
X
X
X
X
X
X
X
X
X
X
X
N
X
X
X
X
X
X
X
X
X
X
X
X
X
w
a
a
a
a
a
a
a
"}
(24,1,1) = {"
a
a
a
a
a
a
a
a
a
j
x
x
x
y
X
u
X
X
X
N
X
X
X
X
N
N
X
X
X
X
X
X
X
N
X
X
X
X
X
X
X
X
X
X
N
X
X
X
X
X
X
X
X
X
N
X
X
X
X
X
X
X
X
X
N
X
X
w
a
a
a
a
a
a
a
"}
(25,1,1) = {"
a
a
a
a
a
a
a
a
a
j
j
j
j
j
Q
Q
X
X
N
X
X
X
X
X
X
X
N
N
N
X
X
X
X
X
X
X
X
X
X
X
X
X
X
X
X
X
X
X
X
X
X
X
X
X
X
X
X
X
X
X
X
X
X
X
X
X
X
w
a
a
a
a
a
a
a
"}
(26,1,1) = {"
a
a
a
a
a
a
a
a
a
a
a
a
a
a
w
w
X
N
X
X
X
X
X
X
X
X
X
X
N
N
X
X
X
X
X
X
X
X
X
X
X
X
X
X
X
X
X
X
X
X
X
N
X
X
N
X
N
X
X
X
X
X
X
X
X
N
X
w
a
a
a
a
a
a
a
"}
(27,1,1) = {"
a
a
a
a
a
a
a
a
a
a
a
a
a
a
a
w
X
N
X
X
X
X
X
X
X
X
X
X
X
X
X
X
X
X
X
X
X
X
X
X
X
X
X
X
X
X
X
X
X
X
X
N
X
X
N
X
X
X
X
X
X
X
X
X
N
X
X
w
a
a
a
a
a
a
a
"}
(28,1,1) = {"
a
a
a
a
a
a
a
a
a
a
a
a
a
a
a
w
X
X
X
X
X
X
X
X
X
X
X
X
X
X
X
X
X
X
X
X
X
X
X
X
X
X
X
X
X
X
X
X
N
X
X
X
X
X
X
X
X
X
X
N
X
X
X
X
N
X
X
w
a
a
a
a
a
a
a
"}
(29,1,1) = {"
a
a
a
a
a
a
a
a
a
a
a
a
a
a
a
w
X
X
N
X
X
X
X
X
X
N
N
X
N
N
X
N
X
X
X
X
X
X
X
X
X
X
X
X
X
N
X
X
N
X
X
N
X
X
X
X
X
X
X
X
X
X
X
X
N
N
X
w
a
a
a
a
a
a
a
"}
(30,1,1) = {"
a
a
a
a
a
a
a
a
a
a
a
a
a
a
a
w
X
X
N
X
X
X
X
X
N
X
X
X
X
X
X
X
N
X
X
X
X
X
X
X
X
X
X
X
N
N
X
X
N
X
X
N
X
X
N
X
X
X
X
X
X
X
X
X
N
N
X
w
a
a
a
a
a
a
a
"}
(31,1,1) = {"
a
a
a
a
a
a
a
a
a
a
w
w
w
w
w
w
X
X
X
X
X
X
X
X
N
N
X
X
X
X
X
X
X
X
X
X
X
X
X
X
X
X
X
X
X
X
X
X
X
X
N
X
X
X
X
X
X
X
X
X
X
X
X
X
X
N
X
w
a
a
a
a
a
a
a
"}
(32,1,1) = {"
a
a
a
a
a
a
a
a
a
a
w
X
v
v
X
X
X
X
X
X
X
X
X
X
X
X
X
X
X
X
X
X
X
X
X
N
N
X
X
X
X
X
X
X
X
X
X
X
N
X
X
N
X
X
N
X
X
X
X
X
X
X
X
X
X
X
X
w
a
a
a
a
a
a
a
"}
(33,1,1) = {"
a
a
a
a
a
a
a
a
a
a
w
e
k
C
X
X
X
X
X
X
X
X
X
X
X
X
X
X
X
X
X
X
X
X
X
X
N
N
X
X
X
X
N
N
X
X
N
X
X
X
X
N
X
X
N
X
X
X
X
X
X
X
X
X
X
X
X
w
a
a
a
a
a
a
a
"}
(34,1,1) = {"
a
a
a
a
a
a
a
a
a
a
w
e
b
s
X
X
X
X
X
X
X
X
X
X
X
X
X
X
X
N
N
X
X
X
X
X
X
N
N
X
X
X
X
X
N
N
N
X
X
X
X
X
X
X
X
X
X
X
X
X
X
X
X
X
X
X
X
w
a
a
a
a
a
a
a
"}
(35,1,1) = {"
a
a
a
a
a
a
a
a
a
a
w
Y
l
Z
X
X
X
X
X
X
X
X
X
X
X
X
X
X
X
X
X
N
X
X
X
X
X
X
N
N
X
X
N
X
X
X
X
X
X
X
X
X
X
X
X
X
X
X
X
X
X
X
X
X
X
N
X
w
a
a
a
a
a
a
a
"}
(36,1,1) = {"
a
a
a
a
a
a
a
a
a
a
w
X
o
o
X
X
X
X
X
X
X
X
X
X
X
X
X
X
X
X
X
X
N
X
X
X
X
X
X
N
X
X
X
X
X
X
X
X
X
N
X
X
X
X
X
X
X
X
X
X
X
X
X
X
X
N
X
w
a
a
a
a
a
a
a
"}
(37,1,1) = {"
a
a
a
a
a
a
a
a
a
a
w
w
w
w
w
w
X
X
X
X
X
X
X
X
X
X
X
X
X
X
X
X
X
N
X
X
X
X
X
X
N
N
X
X
X
X
X
X
X
X
X
X
X
X
X
X
X
X
X
X
X
X
X
X
X
X
X
w
a
a
a
a
a
a
a
"}
(38,1,1) = {"
a
a
a
a
a
a
a
a
a
a
a
a
a
a
a
w
X
X
X
X
X
X
X
X
X
X
X
X
X
X
X
X
X
N
N
X
X
X
X
X
X
E
X
X
X
X
X
X
X
X
X
X
X
X
X
N
X
X
X
X
X
X
X
X
X
X
X
w
a
a
a
a
a
a
a
"}
(39,1,1) = {"
a
a
a
a
a
a
a
a
a
a
a
a
a
a
a
w
X
X
X
X
X
X
X
X
X
X
X
X
X
X
X
X
X
X
X
X
X
X
X
X
X
X
N
X
X
X
X
X
X
X
X
X
X
X
X
N
X
X
X
X
X
X
X
X
X
X
X
w
a
a
a
a
a
a
a
"}
(40,1,1) = {"
a
a
a
a
a
a
a
a
a
a
a
a
a
a
a
w
X
X
X
E
X
X
X
X
X
X
X
X
X
X
X
X
X
X
X
X
X
X
X
X
N
X
X
N
N
X
X
X
X
X
X
X
X
X
X
X
X
X
X
X
X
X
X
X
X
N
X
w
a
a
a
a
a
a
a
"}
(41,1,1) = {"
a
a
a
a
a
a
a
a
a
a
a
a
a
a
a
w
X
X
X
X
X
X
X
X
X
X
X
X
X
X
X
X
X
X
X
X
N
X
X
N
N
X
X
X
N
X
X
X
N
X
X
X
X
X
N
X
X
X
X
X
X
X
X
X
X
N
X
w
a
a
a
a
a
a
a
"}
(42,1,1) = {"
a
a
a
a
a
a
a
a
a
a
a
a
a
a
a
w
X
X
X
N
X
X
X
X
X
X
N
X
X
X
X
X
X
X
X
X
X
X
X
N
X
X
X
X
X
N
X
X
X
X
X
X
X
X
N
X
X
X
X
X
X
X
X
X
X
N
X
w
a
a
a
a
a
a
a
"}
(43,1,1) = {"
a
a
a
a
a
a
a
a
a
a
a
a
a
a
a
w
X
X
X
N
X
X
X
X
N
N
X
X
X
X
X
X
X
X
X
X
X
X
X
X
X
X
X
X
N
N
X
X
X
X
X
X
X
N
N
X
X
X
X
X
X
X
X
X
X
N
X
w
a
a
a
a
a
a
a
"}
(44,1,1) = {"
a
a
a
a
a
a
a
a
a
a
a
a
a
a
a
w
X
X
X
N
X
X
X
X
N
X
X
X
X
X
X
X
X
X
X
X
X
X
X
X
X
X
X
X
N
X
X
X
X
X
X
X
X
N
X
X
X
X
X
X
X
X
X
X
X
N
X
w
a
a
a
a
a
a
a
"}
(45,1,1) = {"
a
a
a
a
a
a
a
a
a
a
a
a
a
a
a
w
X
X
N
X
X
X
X
X
X
N
X
X
X
X
X
X
X
X
X
X
X
X
X
X
X
X
X
X
N
X
X
X
X
X
X
X
X
N
X
X
X
X
X
X
X
X
X
X
X
N
X
w
a
a
a
a
a
a
a
"}
(46,1,1) = {"
a
a
a
a
a
a
a
a
a
a
a
a
a
a
a
w
X
X
N
X
X
X
X
X
X
X
N
X
X
X
X
X
X
X
X
X
X
X
X
X
X
X
X
X
X
X
X
X
X
X
X
X
X
N
X
X
X
X
X
X
X
X
X
X
X
X
X
w
a
a
a
a
a
a
a
"}
(47,1,1) = {"
a
a
a
a
a
a
a
a
a
a
a
a
a
a
a
w
X
X
X
X
X
X
X
X
X
X
X
N
X
X
X
X
X
X
X
X
X
X
X
X
X
X
X
X
N
X
X
X
X
X
X
X
X
X
X
X
X
X
X
X
X
X
X
X
X
X
X
w
a
a
a
a
a
a
a
"}
(48,1,1) = {"
a
a
a
a
a
a
a
a
a
a
a
a
a
a
a
w
X
X
N
X
X
X
X
X
X
X
X
X
N
X
X
X
X
X
X
X
X
X
X
X
X
N
N
X
X
X
X
X
X
X
X
X
X
X
X
X
X
X
X
X
X
X
X
X
X
X
X
w
a
a
a
a
a
a
a
"}
(49,1,1) = {"
a
a
a
a
a
a
a
a
a
a
a
a
a
a
a
w
X
X
X
X
X
X
X
X
X
X
X
X
X
N
X
X
X
X
X
X
X
X
X
X
X
X
N
X
X
X
X
X
X
X
X
X
X
X
X
X
N
N
X
X
X
X
X
X
X
N
X
w
a
a
a
a
a
a
a
"}
(50,1,1) = {"
a
a
a
a
a
a
a
a
a
a
a
a
a
a
a
w
X
X
X
X
X
X
X
X
X
X
X
X
X
X
X
X
X
X
X
X
X
X
X
X
X
X
X
X
X
X
X
X
X
X
X
X
X
X
X
X
X
X
X
X
X
X
X
X
X
N
X
w
a
a
a
a
a
a
a
"}
(51,1,1) = {"
a
a
a
a
a
a
a
a
a
a
a
a
a
a
a
w
X
X
X
X
X
X
X
X
X
X
N
N
N
X
X
X
X
X
X
N
X
X
X
X
X
X
X
X
N
X
X
X
X
X
X
X
X
X
X
X
X
X
X
X
X
X
X
X
X
X
X
w
a
a
a
a
a
a
a
"}
(52,1,1) = {"
a
a
a
a
a
a
a
a
a
a
a
a
a
a
a
w
X
X
X
X
X
X
N
N
X
X
X
X
X
X
X
X
X
X
X
X
N
N
X
X
X
X
X
X
N
X
X
X
N
E
N
N
X
X
X
X
X
X
X
X
X
N
X
X
X
X
X
w
a
a
a
a
a
a
a
"}
(53,1,1) = {"
a
a
a
a
a
a
a
a
a
a
a
a
a
a
a
w
X
X
X
X
X
X
X
X
X
N
X
X
X
X
X
X
X
X
X
X
X
X
X
X
N
N
X
N
X
N
N
X
X
X
X
X
X
X
X
X
X
X
X
X
N
X
X
X
X
N
X
w
a
a
a
a
a
a
a
"}
(54,1,1) = {"
a
a
a
a
a
a
a
a
a
a
a
a
a
a
a
w
X
N
X
X
X
X
X
X
X
X
X
N
X
X
X
N
N
X
X
X
X
X
N
X
N
N
X
X
X
X
X
X
X
X
X
X
X
X
X
X
X
X
X
X
X
X
X
X
X
N
X
w
a
a
a
a
a
a
a
"}
(55,1,1) = {"
a
a
a
a
a
a
a
a
a
a
a
a
a
a
a
w
X
N
X
X
X
X
X
X
X
X
X
X
N
N
X
X
N
X
X
X
X
X
X
X
X
X
X
X
N
X
X
X
X
X
X
X
X
X
X
X
X
X
X
X
X
X
X
X
X
X
X
w
a
a
a
a
a
a
a
"}
(56,1,1) = {"
a
a
a
a
a
a
a
a
a
a
a
a
a
a
a
w
X
X
X
X
X
X
X
X
X
X
X
X
X
X
X
N
N
X
X
X
X
X
X
X
X
X
X
X
N
X
X
X
X
X
X
X
X
X
N
N
X
X
X
X
X
X
X
X
N
X
X
w
a
a
a
a
a
a
a
"}
(57,1,1) = {"
a
a
a
a
a
a
a
a
a
a
a
a
a
a
a
w
X
X
X
X
X
X
X
X
X
X
X
X
X
X
X
X
X
X
X
X
X
X
X
X
X
X
X
X
X
X
X
X
X
N
N
X
X
X
X
X
X
X
X
X
X
X
X
X
N
X
X
w
a
a
a
a
a
a
a
"}
(58,1,1) = {"
a
a
a
a
a
a
a
a
a
a
a
a
a
a
a
w
X
X
X
X
N
N
N
X
X
X
X
X
X
X
X
X
X
X
X
X
X
X
X
X
X
X
X
X
X
X
X
X
X
X
E
X
N
N
N
X
X
X
X
X
X
X
X
X
N
X
X
w
a
a
a
a
a
a
a
"}
(59,1,1) = {"
a
a
a
a
a
a
a
a
a
a
a
a
a
a
a
w
X
X
X
X
X
X
X
X
N
X
X
X
X
X
X
X
X
X
X
X
X
X
X
N
X
N
N
N
E
X
X
X
X
X
N
N
X
X
X
X
X
X
X
X
X
X
X
X
N
X
X
w
a
a
a
a
a
a
a
"}
(60,1,1) = {"
a
a
a
a
a
a
a
a
a
a
a
a
a
a
a
w
X
X
N
X
X
X
X
X
X
N
N
X
X
X
X
X
X
X
X
X
X
X
X
X
X
X
X
X
E
X
X
X
X
N
X
X
X
X
X
X
X
X
X
X
X
X
X
X
N
X
X
w
a
a
a
a
a
a
a
"}
(61,1,1) = {"
a
a
a
a
a
a
a
a
a
a
a
a
a
a
a
w
X
X
X
N
N
N
X
X
X
N
N
X
X
X
X
X
X
X
X
X
X
X
X
X
X
X
X
X
X
X
X
N
X
X
X
N
X
X
X
N
X
N
X
N
N
N
N
N
X
X
X
w
a
a
a
a
a
a
a
"}
(62,1,1) = {"
a
a
a
a
a
a
a
a
a
a
a
a
a
a
a
w
X
X
X
X
X
X
X
X
X
X
X
X
X
X
X
X
X
X
X
X
X
X
X
X
X
X
X
X
N
N
X
X
X
X
N
N
X
X
X
X
N
N
N
X
X
X
X
X
X
X
X
w
a
a
a
a
a
a
a
"}
(63,1,1) = {"
a
a
a
a
a
a
a
a
a
a
a
a
a
a
a
w
X
X
X
X
X
X
X
X
X
X
X
X
X
X
X
X
X
X
X
X
X
X
X
X
X
X
N
X
X
X
X
X
X
X
X
X
X
X
X
N
X
X
X
X
X
X
X
X
X
X
X
w
a
a
a
a
a
a
a
"}
(64,1,1) = {"
a
a
a
a
a
a
a
a
a
a
a
a
a
a
a
w
w
w
w
w
w
w
w
w
w
w
w
w
w
w
w
w
w
w
w
w
w
w
w
w
w
w
w
w
w
w
w
w
w
w
w
w
w
w
w
w
w
w
w
w
w
w
w
w
w
w
w
w
a
a
a
a
a
a
a
"}
(65,1,1) = {"
a
a
a
a
a
a
a
a
a
a
a
a
a
a
a
a
a
a
a
a
a
a
a
a
a
a
a
a
a
a
a
a
a
a
a
a
a
a
a
a
a
a
a
a
a
a
a
a
a
a
a
a
a
a
a
a
a
a
a
a
a
a
a
a
a
a
a
a
a
a
a
a
a
a
a
"}
(66,1,1) = {"
a
a
a
a
a
a
a
a
a
a
a
a
a
a
a
a
a
a
a
a
a
a
a
a
a
a
a
a
a
a
a
a
a
a
a
a
a
a
a
a
a
a
a
a
a
a
a
a
a
a
a
a
a
a
a
a
a
a
a
a
a
a
a
a
a
a
a
a
a
a
a
a
a
a
a
"}
(67,1,1) = {"
a
a
a
a
a
a
a
a
a
a
a
a
a
a
a
a
a
a
a
a
a
a
a
a
a
a
a
a
a
a
a
a
a
a
a
a
a
a
a
a
a
a
a
a
a
a
a
a
a
a
a
a
a
a
a
a
a
a
a
a
a
a
a
a
a
a
a
a
a
a
a
a
a
a
a
"}
(68,1,1) = {"
a
a
a
a
a
a
a
a
a
a
a
a
a
a
a
a
a
a
a
a
a
a
a
a
a
a
a
a
a
a
a
a
a
a
a
a
a
a
a
a
a
a
a
a
a
a
a
a
a
a
a
a
a
a
a
a
a
a
a
a
a
a
a
a
a
a
a
a
a
a
a
a
a
a
a
"}
(69,1,1) = {"
a
a
a
a
a
a
a
a
a
a
a
a
a
a
a
a
a
a
a
a
a
a
a
a
a
a
a
a
a
a
a
a
a
a
a
a
a
a
a
a
a
a
a
a
a
a
a
a
a
a
a
a
a
a
a
a
a
a
a
a
a
a
a
a
a
a
a
a
a
a
a
a
a
a
a
"}
(70,1,1) = {"
a
a
a
a
a
a
a
a
a
a
a
a
a
a
a
a
a
a
a
a
a
a
a
a
a
a
a
a
a
a
a
a
a
a
a
a
a
a
a
a
a
a
a
a
a
a
a
a
a
a
a
a
a
a
a
a
a
a
a
a
a
a
a
a
a
a
a
a
a
a
a
a
a
a
a
"}
