//MAP CONVERTED BY dmm2tgm.py THIS HEADER COMMENT PREVENTS RECONVERSION, DO NOT REMOVE
"a" = (
/obj/effect/dummy/lighting_obj{
	light_range = 10
	},
/turf/open/floor/glass/cyan,
/area/hangar)
"e" = (
/obj/machinery/door/airlock,
/obj/effect/landmark/outpost/elevator_machine,
/turf/open/floor/glass/cyan,
/area/hangar)
"g" = (
/turf/open/floor/glass/cyan,
/area/hangar)
"i" = (
/turf/open/space/basic,
/area/template_noop)
"v" = (
/turf/open/floor/plasteel/elevatorshaft{
	planetary_atmos = 1
	},
/area/hangar)
"w" = (
/obj/effect/landmark/outpost/shaft_number,
/turf/open/floor/glass/cyan,
/area/hangar)
"x" = (
/obj/effect/landmark/outpost/elevator_machine,
/obj/machinery/elevator_call_button{
	pixel_y = 31;
	pixel_x = 10
	},
/turf/open/floor/glass/cyan,
/area/hangar)
"y" = (
/obj/effect/landmark/outpost/elevator,
/turf/open/floor/plasteel/elevatorshaft{
	planetary_atmos = 1
	},
/area/hangar)
"A" = (
/obj/effect/landmark/outpost/hangar_dock,
/obj/effect/dummy/lighting_obj{
	light_range = 10
	},
/turf/open/floor/glass/cyan,
/area/hangar)
"F" = (
/obj/structure/window/reinforced/fulltile/indestructible{
	alpha = 0
	},
/turf/open/space/basic,
/area/hangar)
"L" = (
/turf/closed/indestructible/reinforced,
/area/hangar)
"S" = (
/obj/effect/landmark/outpost/hangar_numbers,
/turf/open/floor/glass/cyan,
/area/hangar)
"T" = (
/obj/effect/dummy/lighting_obj{
	light_range = 10
	},
/obj/effect/dummy/lighting_obj{
	light_range = 10
	},
/turf/open/floor/glass/cyan,
/area/hangar)
"W" = (
/turf/open/space/anima,
/area/template_noop)

(1,1,1) = {"
i
i
i
i
i
i
i
i
i
i
i
i
i
i
i
i
i
i
i
i
i
i
i
i
i
i
i
i
i
i
i
i
i
i
i
i
i
i
i
i
i
i
i
i
i
i
"}
(2,1,1) = {"
i
i
i
i
i
i
i
i
i
i
i
i
i
i
i
i
i
i
i
i
i
i
i
i
i
i
i
i
i
i
i
i
i
i
i
i
i
i
i
i
i
i
i
i
i
i
"}
(3,1,1) = {"
i
i
i
i
i
i
i
i
i
i
i
i
i
i
i
i
i
i
i
i
i
i
i
i
i
i
i
i
i
i
i
i
i
i
i
i
i
i
i
i
i
i
i
i
i
i
"}
(4,1,1) = {"
i
i
i
i
i
i
i
i
i
i
i
i
i
i
i
i
i
i
i
i
i
i
i
i
i
i
i
i
i
i
i
i
i
i
i
i
i
i
i
i
i
i
i
i
i
i
"}
(5,1,1) = {"
i
i
i
i
i
i
i
i
i
i
i
i
i
i
i
i
i
i
i
i
i
i
i
i
i
i
i
i
i
i
i
i
i
i
i
i
i
i
i
i
i
i
i
i
i
i
"}
(6,1,1) = {"
i
i
i
i
i
i
i
i
i
i
i
i
i
i
i
i
i
i
i
i
i
i
i
i
i
i
i
i
i
i
i
i
i
i
i
i
i
i
i
i
i
i
i
i
i
i
"}
(7,1,1) = {"
i
i
i
i
i
i
i
i
i
i
i
i
i
i
i
i
i
i
i
i
i
i
i
i
i
i
i
i
i
i
i
i
i
i
i
i
i
i
i
i
i
i
i
i
i
i
"}
(8,1,1) = {"
i
i
i
i
i
i
i
i
i
i
i
i
i
i
i
i
i
i
i
i
i
i
i
i
i
i
i
i
i
i
i
i
i
i
i
i
i
i
i
i
i
i
i
i
i
i
"}
(9,1,1) = {"
i
i
i
i
i
i
i
i
i
i
i
i
i
i
i
i
i
i
i
i
i
i
i
i
i
i
i
i
i
i
i
i
i
i
i
i
i
i
i
i
i
i
i
i
i
i
"}
(10,1,1) = {"
i
i
i
i
i
i
i
i
i
i
i
i
F
F
F
F
F
F
F
F
F
F
F
F
F
F
F
F
F
F
F
F
F
F
F
F
F
F
F
i
i
i
i
i
i
i
"}
(11,1,1) = {"
i
i
i
i
i
i
i
i
i
i
i
i
F
a
a
a
a
a
a
a
a
a
a
a
a
a
a
a
a
a
a
a
a
a
a
a
a
a
F
i
i
i
i
i
i
i
"}
(12,1,1) = {"
i
i
i
i
i
i
i
i
i
i
i
i
F
a
a
a
a
a
a
a
a
a
a
a
a
a
a
a
a
a
a
a
a
a
a
a
a
a
F
i
i
i
i
i
i
i
"}
(13,1,1) = {"
i
i
i
i
i
i
W
W
W
W
W
i
F
a
a
T
a
a
a
T
a
a
a
T
a
a
a
T
a
a
a
T
a
a
a
T
a
a
F
i
i
i
i
i
i
i
"}
(14,1,1) = {"
i
i
i
i
i
i
W
W
W
W
W
i
F
a
a
a
a
a
a
a
a
a
a
a
a
a
a
a
a
a
a
a
a
a
a
a
a
a
F
i
i
i
i
i
i
i
"}
(15,1,1) = {"
i
i
i
i
i
i
W
W
W
W
W
i
F
a
a
a
a
a
a
a
a
a
a
a
a
a
a
a
a
a
a
a
a
A
a
a
a
a
F
i
i
i
i
i
i
i
"}
(16,1,1) = {"
i
i
i
i
i
i
W
W
W
W
W
i
F
a
a
a
a
a
a
a
a
a
a
a
a
a
a
a
a
a
a
a
a
a
a
a
a
a
F
i
i
i
i
i
i
i
"}
(17,1,1) = {"
i
i
i
i
i
i
i
i
i
i
i
i
F
a
a
T
a
a
a
a
a
a
a
a
a
a
a
a
a
a
a
a
a
a
a
T
a
a
F
i
i
i
i
i
i
i
"}
(18,1,1) = {"
i
i
i
i
i
i
i
i
i
i
i
i
F
a
a
a
a
a
a
a
a
a
a
a
a
a
a
a
a
a
a
T
a
a
a
a
a
a
F
i
i
i
i
i
i
i
"}
(19,1,1) = {"
i
i
i
i
i
i
i
i
i
i
i
i
F
a
a
a
a
a
a
a
a
a
a
a
a
a
a
a
a
a
a
a
a
a
a
a
a
a
F
i
i
i
i
i
i
i
"}
(20,1,1) = {"
i
i
i
i
i
i
i
i
i
i
i
i
F
a
a
a
a
a
a
a
a
a
a
a
a
a
a
a
a
a
a
a
a
a
T
a
a
a
F
i
i
i
i
i
i
i
"}
(21,1,1) = {"
i
i
i
i
i
i
i
i
i
i
i
F
F
a
a
T
a
a
a
a
a
a
a
a
a
a
a
a
a
a
a
a
a
a
a
T
a
a
F
i
i
i
i
i
i
i
"}
(22,1,1) = {"
i
i
i
i
i
i
L
L
L
L
L
x
g
a
a
a
a
a
a
a
a
a
a
a
a
a
a
a
a
a
a
a
a
a
a
a
a
a
F
i
i
i
i
i
i
i
"}
(23,1,1) = {"
i
i
i
i
i
i
L
v
v
y
e
a
g
a
a
a
a
a
a
a
a
a
a
a
a
a
a
a
a
a
a
a
a
a
a
a
a
a
F
i
i
i
i
i
i
i
"}
(24,1,1) = {"
i
i
i
i
i
i
L
v
v
v
e
g
w
a
a
a
a
a
a
a
a
a
a
a
a
a
a
a
a
a
a
a
a
a
a
a
a
a
F
i
i
i
i
i
i
i
"}
(25,1,1) = {"
i
i
i
i
i
i
L
v
v
v
e
a
S
a
a
T
a
a
a
a
a
a
a
a
a
a
a
a
a
a
a
a
a
a
a
T
a
a
F
i
i
i
i
i
i
i
"}
(26,1,1) = {"
i
i
i
i
i
i
L
L
L
L
L
g
g
a
a
a
a
a
a
a
a
a
a
a
a
a
a
a
a
a
a
a
a
a
a
a
a
a
F
i
i
i
i
i
i
i
"}
(27,1,1) = {"
i
i
i
i
i
i
i
i
i
i
i
F
F
a
a
a
a
a
a
a
a
a
a
a
a
a
a
a
a
a
a
a
a
a
a
a
a
a
F
i
i
i
i
i
i
i
"}
(28,1,1) = {"
i
i
i
i
i
i
i
i
i
i
i
i
F
a
a
a
a
a
a
a
a
a
a
a
a
a
a
a
a
a
a
a
a
a
a
a
a
a
F
i
i
i
i
i
i
i
"}
(29,1,1) = {"
i
i
i
i
i
i
i
i
i
i
i
i
F
a
a
T
a
a
a
a
a
a
a
a
a
a
a
a
a
a
a
a
a
a
a
T
a
a
F
i
i
i
i
i
i
i
"}
(30,1,1) = {"
i
i
i
i
i
i
i
i
i
i
i
i
F
a
a
a
a
a
a
a
a
a
a
a
a
a
a
a
a
a
a
a
a
a
a
a
a
a
F
i
i
i
i
i
i
i
"}
(31,1,1) = {"
i
i
i
i
i
i
i
i
i
i
i
i
F
a
a
a
a
a
a
a
a
a
a
a
a
a
a
a
a
a
a
a
a
a
a
a
a
a
F
i
i
i
i
i
i
i
"}
(32,1,1) = {"
i
i
i
i
i
i
i
i
i
i
i
i
F
a
a
a
a
a
a
a
a
a
a
a
a
a
a
a
a
a
a
a
a
a
a
a
a
a
F
i
i
i
i
i
i
i
"}
(33,1,1) = {"
i
i
i
i
i
i
i
i
i
i
i
i
F
a
a
T
a
a
a
a
a
a
a
a
a
a
a
a
a
a
a
a
a
a
a
T
a
a
F
i
i
i
i
i
i
i
"}
(34,1,1) = {"
i
i
i
i
i
i
i
i
i
i
i
i
F
a
a
a
a
a
T
a
a
a
T
a
a
a
T
a
a
a
T
a
a
a
a
a
a
a
F
i
i
i
i
i
i
i
"}
(35,1,1) = {"
i
i
i
i
i
i
i
i
i
i
i
i
F
a
a
a
a
a
a
a
a
a
a
a
a
a
a
a
a
a
a
a
a
a
a
a
a
a
F
i
i
i
i
i
i
i
"}
(36,1,1) = {"
i
i
i
i
i
i
i
i
i
i
i
i
F
T
a
a
a
a
a
a
a
a
a
a
a
a
a
a
a
a
a
a
a
a
a
a
a
a
F
i
i
i
i
i
i
i
"}
(37,1,1) = {"
i
i
i
i
i
i
i
i
i
i
i
i
F
F
F
F
F
F
F
F
F
F
F
F
F
F
F
F
F
F
F
F
F
F
F
F
F
F
F
i
i
i
i
i
i
i
"}
(38,1,1) = {"
i
i
i
i
i
i
i
i
i
i
i
i
i
i
i
i
i
i
i
i
i
i
i
i
i
i
i
i
i
i
i
i
i
i
i
i
i
i
i
i
i
i
i
i
i
i
"}
(39,1,1) = {"
i
i
i
i
i
i
i
i
i
i
i
i
i
i
i
i
i
i
i
i
i
i
i
i
i
i
i
i
i
i
i
i
i
i
i
i
i
i
i
i
i
i
i
i
i
i
"}
(40,1,1) = {"
i
i
i
i
i
i
i
i
i
i
i
i
i
i
i
i
i
i
i
i
i
i
i
i
i
i
i
i
i
i
i
i
i
i
i
i
i
i
i
i
i
i
i
i
i
i
"}
(41,1,1) = {"
i
i
i
i
i
i
i
i
i
i
i
i
i
i
i
i
i
i
i
i
i
i
i
i
i
i
i
i
i
i
i
i
i
i
i
i
i
i
i
i
i
i
i
i
i
i
"}
(42,1,1) = {"
i
i
i
i
i
i
i
i
i
i
i
i
i
i
i
i
i
i
i
i
i
i
i
i
i
i
i
i
i
i
i
i
i
i
i
i
i
i
i
i
i
i
i
i
i
i
"}
(43,1,1) = {"
i
i
i
i
i
i
i
i
i
i
i
i
i
i
i
i
i
i
i
i
i
i
i
i
i
i
i
i
i
i
i
i
i
i
i
i
i
i
i
i
i
i
i
i
i
i
"}
(44,1,1) = {"
i
i
i
i
i
i
i
i
i
i
i
i
i
i
i
i
i
i
i
i
i
i
i
i
i
i
i
i
i
i
i
i
i
i
i
i
i
i
i
i
i
i
i
i
i
i
"}
(45,1,1) = {"
i
i
i
i
i
i
i
i
i
i
i
i
i
i
i
i
i
i
i
i
i
i
i
i
i
i
i
i
i
i
i
i
i
i
i
i
i
i
i
i
i
i
i
i
i
i
"}
(46,1,1) = {"
i
i
i
i
i
i
i
i
i
i
i
i
i
i
i
i
i
i
i
i
i
i
i
i
i
i
i
i
i
i
i
i
i
i
i
i
i
i
i
i
i
i
i
i
i
i
"}
