//MAP CONVERTED BY dmm2tgm.py THIS HEADER COMMENT PREVENTS RECONVERSION, DO NOT REMOVE
"a" = (
/obj/effect/dummy/lighting_obj{
	light_range = 10
	},
/turf/open/floor/glass/cyan,
/area/hangar)
"b" = (
/obj/effect/portal/permanent/one_way{
	id = "cargo_20x20"
	},
/obj/effect/dummy/lighting_obj{
	light_range = 10
	},
/turf/open/floor/glass/cyan,
/area/hangar)
"c" = (
/obj/effect/landmark/portal_exit{
	id = "cargo_20x20"
	},
/obj/machinery/conveyor/auto/outpost,
/obj/effect/dummy/lighting_obj{
	light_range = 10
	},
/turf/open/floor/glass/cyan,
/area/hangar)
"e" = (
/obj/structure/plasticflaps/outpost,
/obj/machinery/conveyor/auto/outpost,
/obj/effect/dummy/lighting_obj{
	light_range = 10
	},
/turf/open/floor/glass/cyan,
/area/hangar)
"i" = (
/obj/effect/landmark/outpost/elevator,
/turf/open/floor/plasteel/elevatorshaft{
	planetary_atmos = 1
	},
/area/hangar)
"j" = (
/obj/machinery/conveyor/auto/outpost{
	dir = 4
	},
/obj/effect/dummy/lighting_obj{
	light_range = 10
	},
/turf/open/floor/glass/cyan,
/area/hangar)
"k" = (
/obj/machinery/conveyor/auto{
	dir = 5;
	id = "outpost3"
	},
/obj/effect/dummy/lighting_obj{
	light_range = 10
	},
/turf/open/floor/glass/cyan,
/area/hangar)
"l" = (
/obj/effect/landmark/outpost/hangar_crate_spawner,
/obj/machinery/conveyor/auto/outpost{
	dir = 8
	},
/turf/open/floor/glass/cyan,
/area/hangar)
"m" = (
/obj/effect/dummy/lighting_obj{
	light_range = 10
	},
/obj/effect/dummy/lighting_obj{
	light_range = 10
	},
/turf/open/floor/glass/cyan,
/area/hangar)
"n" = (
/obj/effect/dummy/lighting_obj{
	light_range = 10
	},
/obj/effect/dummy/lighting_obj{
	light_range = 10
	},
/obj/effect/dummy/lighting_obj{
	light_range = 10
	},
/turf/open/floor/glass/cyan,
/area/hangar)
"o" = (
/turf/closed/indestructible/reinforced,
/area/hangar)
"q" = (
/obj/structure/window/reinforced/fulltile/indestructible{
	alpha = 0
	},
/turf/open/space/anima,
/area/hangar)
"t" = (
/obj/machinery/conveyor/auto{
	id = "outpost3";
	use_static_power = 1;
	dir = 9
	},
/obj/effect/dummy/lighting_obj{
	light_range = 10
	},
/turf/open/floor/glass/cyan,
/area/hangar)
"u" = (
/obj/machinery/conveyor/auto/outpost{
	dir = 8
	},
/obj/effect/dummy/lighting_obj{
	light_range = 10
	},
/turf/open/floor/glass/cyan,
/area/hangar)
"v" = (
/obj/effect/landmark/outpost/elevator_machine,
/obj/machinery/elevator_call_button{
	pixel_y = 31;
	pixel_x = 10
	},
/turf/open/floor/glass/cyan,
/area/hangar)
"x" = (
/obj/machinery/conveyor/auto/outpost,
/obj/effect/dummy/lighting_obj{
	light_range = 10
	},
/turf/open/floor/glass/cyan,
/area/hangar)
"y" = (
/obj/effect/landmark/outpost/shaft_number,
/turf/open/floor/glass/cyan,
/area/hangar)
"z" = (
/turf/open/floor/plasteel/elevatorshaft{
	planetary_atmos = 1
	},
/area/hangar)
"B" = (
/obj/machinery/door/airlock,
/obj/effect/landmark/outpost/elevator_machine,
/turf/open/floor/glass/cyan,
/area/hangar)
"E" = (
/obj/machinery/conveyor/auto{
	dir = 4;
	id = "outpost3"
	},
/obj/machinery/recycler,
/obj/effect/dummy/lighting_obj{
	light_range = 10
	},
/turf/open/floor/glass/cyan,
/area/hangar)
"F" = (
/obj/machinery/conveyor/auto/outpost{
	dir = 1
	},
/obj/effect/dummy/lighting_obj{
	light_range = 10
	},
/turf/open/floor/glass/cyan,
/area/hangar)
"G" = (
/obj/machinery/conveyor/auto{
	dir = 10
	},
/obj/effect/dummy/lighting_obj{
	light_range = 10
	},
/turf/open/floor/glass/cyan,
/area/hangar)
"I" = (
/obj/structure/railing{
	dir = 8
	},
/obj/effect/dummy/lighting_obj{
	light_range = 10
	},
/turf/open/floor/glass/cyan,
/area/hangar)
"J" = (
/turf/open/floor/glass/cyan,
/area/hangar)
"K" = (
/obj/structure/railing{
	dir = 4
	},
/obj/effect/dummy/lighting_obj{
	light_range = 10
	},
/turf/open/floor/glass/cyan,
/area/hangar)
"M" = (
/turf/open/space/basic,
/area/template_noop)
"Q" = (
/obj/effect/dummy/lighting_obj{
	light_range = 10
	},
/obj/effect/dummy/lighting_obj{
	light_range = 10
	},
/obj/structure/railing,
/turf/open/floor/glass/cyan,
/area/hangar)
"R" = (
/obj/structure/railing,
/obj/effect/dummy/lighting_obj{
	light_range = 10
	},
/turf/open/floor/glass/cyan,
/area/hangar)
"S" = (
/obj/effect/landmark/outpost/hangar_dock,
/obj/effect/dummy/lighting_obj{
	light_range = 10
	},
/turf/open/floor/glass/cyan,
/area/hangar)
"T" = (
/obj/machinery/conveyor/auto{
	dir = 6;
	id = "outpost3"
	},
/obj/effect/dummy/lighting_obj{
	light_range = 10
	},
/turf/open/floor/glass/cyan,
/area/hangar)
"U" = (
/obj/structure/window/reinforced/fulltile/indestructible{
	alpha = 0
	},
/turf/open/space/basic,
/area/hangar)
"W" = (
/obj/structure/window/reinforced/fulltile/indestructible{
	alpha = 0
	},
/obj/effect/dummy/lighting_obj{
	light_range = 10
	},
/turf/open/space/basic,
/area/hangar)
"Y" = (
/obj/effect/landmark/outpost/hangar_numbers,
/turf/open/floor/glass/cyan,
/area/hangar)
"Z" = (
/obj/machinery/conveyor/auto{
	dir = 8
	},
/obj/effect/dummy/lighting_obj{
	light_range = 10
	},
/turf/open/floor/glass/cyan,
/area/hangar)

(1,1,1) = {"
U
U
U
M
M
M
M
M
M
M
M
M
M
M
M
M
M
M
M
M
M
M
M
M
M
M
M
M
M
M
M
M
M
M
M
M
M
M
M
M
M
M
M
M
M
M
M
M
M
M
M
M
M
M
M
M
M
M
M
M
M
M
M
M
M
M
M
M
M
M
M
M
M
M
M
"}
(2,1,1) = {"
U
b
U
M
M
M
M
M
M
M
M
M
M
M
M
M
M
M
M
M
M
M
M
M
M
M
M
M
M
M
M
M
M
M
M
M
M
M
M
M
M
M
M
M
M
M
M
M
M
M
M
M
M
M
M
M
M
M
M
M
M
M
M
M
M
M
M
M
M
M
M
M
M
M
M
"}
(3,1,1) = {"
U
l
U
M
M
M
M
M
M
M
M
M
M
M
M
M
M
M
M
M
M
M
M
M
M
M
M
M
M
M
M
M
M
M
M
M
M
M
M
M
M
M
M
M
M
M
M
M
M
M
M
M
M
M
M
M
M
M
M
M
M
M
M
M
M
M
M
M
M
M
M
M
M
M
M
"}
(4,1,1) = {"
U
U
U
M
M
M
M
M
M
M
M
M
M
M
M
M
M
M
M
M
M
M
M
M
M
M
M
M
M
M
M
M
M
M
M
M
M
M
M
M
M
M
M
M
M
M
M
M
M
M
M
M
M
M
M
M
M
M
M
M
M
M
M
M
M
M
M
M
M
M
M
M
M
M
M
"}
(5,1,1) = {"
M
M
M
M
M
M
M
M
M
M
M
M
M
M
M
M
M
M
M
M
M
M
M
M
M
M
M
M
M
M
M
M
M
M
M
M
M
M
M
M
M
M
M
M
M
M
M
M
M
M
M
M
M
M
M
M
M
M
M
M
M
M
M
M
M
M
M
M
M
M
M
M
M
M
M
"}
(6,1,1) = {"
M
M
M
M
M
M
M
M
M
M
M
M
M
M
M
M
M
M
M
M
M
M
M
M
M
M
M
M
M
M
M
M
M
M
M
M
M
M
M
M
M
M
M
M
M
M
M
M
M
M
M
M
M
M
M
M
M
M
M
M
M
M
M
M
M
M
M
M
M
M
M
M
M
M
M
"}
(7,1,1) = {"
M
M
M
M
M
M
M
M
M
M
M
M
M
M
M
M
M
M
M
M
M
M
M
M
M
M
M
M
M
M
M
M
M
M
M
M
M
M
M
M
M
M
M
M
M
M
M
M
M
M
M
M
M
M
M
M
M
M
M
M
M
M
M
M
M
M
M
M
M
M
M
M
M
M
M
"}
(8,1,1) = {"
M
M
M
M
M
M
M
M
M
M
M
M
M
M
M
M
M
M
M
M
M
M
M
M
M
M
M
M
M
M
M
M
M
M
M
M
M
M
M
M
M
M
M
M
M
M
M
M
M
M
M
M
M
M
M
M
M
M
M
M
M
M
M
M
M
M
M
M
M
M
M
M
M
M
M
"}
(9,1,1) = {"
M
M
M
M
M
M
M
M
M
M
M
M
M
M
M
U
U
U
U
U
U
U
U
U
U
U
U
U
U
U
U
U
U
U
U
U
U
U
U
U
U
U
U
U
U
U
U
U
U
U
U
U
U
U
U
U
U
U
U
U
U
U
U
U
U
U
U
U
M
M
M
M
M
M
M
"}
(10,1,1) = {"
M
M
M
M
M
M
M
M
M
M
M
M
M
M
M
U
a
a
a
a
a
a
a
a
a
a
a
a
a
a
a
a
a
a
a
a
a
a
a
a
a
a
a
a
a
a
a
a
a
a
a
a
a
a
a
a
a
a
a
a
a
a
a
a
a
a
a
U
M
M
M
M
M
M
M
"}
(11,1,1) = {"
M
M
M
M
M
M
M
M
M
U
U
U
U
U
U
U
a
a
a
a
a
a
a
a
a
a
a
a
a
a
a
m
m
m
m
a
a
a
a
a
a
a
a
a
a
a
a
a
a
a
a
a
a
a
a
a
a
a
a
a
a
a
a
a
a
a
a
U
M
M
M
M
M
M
M
"}
(12,1,1) = {"
M
M
M
M
M
M
M
M
M
q
a
a
a
a
a
a
a
a
a
a
a
a
a
a
a
a
a
a
a
m
m
a
a
a
a
a
a
a
a
a
a
a
a
a
m
a
a
a
n
a
a
a
m
a
a
a
m
a
a
a
m
a
a
a
m
a
a
U
M
M
M
M
M
M
M
"}
(13,1,1) = {"
M
M
M
M
M
M
M
M
M
q
a
x
x
j
a
a
a
a
a
m
a
a
a
a
a
a
a
a
a
m
m
m
a
a
a
a
a
a
a
a
a
a
a
a
a
a
m
m
m
m
m
a
a
a
a
a
a
a
a
a
a
a
a
a
a
a
a
U
M
M
M
M
M
M
M
"}
(14,1,1) = {"
M
M
M
M
M
M
U
U
U
q
a
u
a
j
a
a
a
a
a
a
a
a
a
a
a
a
a
a
a
a
a
a
a
a
a
a
a
m
m
m
m
a
a
a
a
a
a
a
a
a
a
a
a
a
a
a
a
a
a
a
a
a
S
a
a
a
a
U
M
M
M
M
M
M
M
"}
(15,1,1) = {"
M
M
M
M
M
M
U
c
x
e
x
u
a
j
a
a
a
a
a
m
a
a
a
a
a
a
a
a
a
a
a
a
a
a
a
a
a
a
a
a
a
a
a
a
a
a
a
a
a
a
a
a
a
a
a
a
a
a
a
a
a
a
a
a
a
a
a
U
M
M
M
M
M
M
M
"}
(16,1,1) = {"
M
M
M
M
M
M
U
U
U
U
a
u
a
j
a
a
a
a
a
m
a
a
a
a
a
a
a
a
a
a
a
a
a
a
a
a
a
a
a
a
a
a
a
a
m
a
a
a
a
a
a
a
a
a
a
a
a
a
a
a
a
a
a
a
m
a
a
U
M
M
M
M
M
M
M
"}
(17,1,1) = {"
M
M
M
M
M
M
M
M
M
U
a
u
F
F
a
a
a
a
a
m
a
a
a
a
a
a
a
a
m
m
a
a
a
a
a
a
a
a
a
a
a
a
a
a
a
a
a
a
a
a
a
a
a
m
a
a
a
a
a
a
m
a
a
a
a
a
a
U
M
M
M
M
M
M
M
"}
(18,1,1) = {"
M
M
M
M
M
M
M
M
M
U
a
a
a
a
a
a
a
a
m
a
a
a
a
a
a
a
a
m
a
a
m
a
a
a
a
a
a
a
a
m
a
m
a
a
a
a
a
a
a
a
a
a
m
m
a
a
a
a
m
m
m
m
m
a
a
a
a
U
M
M
M
M
M
M
M
"}
(19,1,1) = {"
M
M
M
M
M
M
M
M
M
U
U
U
U
U
U
U
a
m
m
a
a
a
a
a
a
a
a
a
a
a
a
m
a
a
m
a
a
a
a
a
a
a
a
a
a
a
a
a
a
a
a
a
a
a
n
a
m
a
a
a
a
a
a
m
a
a
a
U
M
M
M
M
M
M
M
"}
(20,1,1) = {"
M
M
M
M
M
M
M
M
M
M
M
M
M
M
U
U
a
m
a
a
a
a
a
a
a
a
a
a
a
m
a
a
a
a
a
a
a
a
a
a
a
a
a
m
m
a
a
a
a
a
a
a
a
a
a
a
a
m
a
a
a
a
a
a
m
a
a
U
M
M
M
M
M
M
M
"}
(21,1,1) = {"
M
M
M
M
M
M
M
M
M
o
o
o
o
o
v
J
a
a
a
a
a
a
a
a
a
a
a
a
a
a
a
a
m
a
a
a
a
a
a
a
a
a
a
a
m
m
a
a
a
a
a
a
a
m
a
m
a
m
a
a
a
a
a
a
a
a
a
U
M
M
M
M
M
M
M
"}
(22,1,1) = {"
M
M
M
M
M
M
M
M
M
o
z
z
i
B
a
J
a
m
a
a
a
a
a
a
a
a
a
a
m
a
a
a
a
m
a
a
a
a
a
a
a
a
a
a
a
m
m
a
a
a
a
a
m
a
a
a
a
m
a
a
a
a
a
a
a
a
a
U
M
M
M
M
M
M
M
"}
(23,1,1) = {"
M
M
M
M
M
M
M
M
M
o
z
z
z
B
J
y
a
m
a
a
a
a
m
a
a
a
a
m
a
a
a
a
a
m
a
a
a
a
a
a
a
a
a
a
a
a
a
a
a
a
a
a
a
m
a
a
a
a
a
a
a
a
a
a
a
a
a
U
M
M
M
M
M
M
M
"}
(24,1,1) = {"
M
M
M
M
M
M
M
M
M
o
z
z
z
B
a
Y
a
a
a
m
a
a
a
a
m
m
a
m
a
a
a
a
a
m
a
a
a
a
a
a
a
a
a
a
m
a
a
a
a
a
a
a
a
a
m
a
a
a
a
a
a
a
a
a
m
a
a
U
M
M
M
M
M
M
M
"}
(25,1,1) = {"
M
M
M
M
M
M
M
M
M
o
o
o
o
o
J
J
a
a
m
a
a
a
a
a
a
a
m
m
m
a
a
a
a
a
a
a
a
a
a
a
a
a
a
a
a
a
a
a
a
a
a
a
a
a
a
m
a
a
a
a
a
a
m
a
a
a
a
U
M
M
M
M
M
M
M
"}
(26,1,1) = {"
M
M
M
M
M
M
M
M
M
M
M
M
M
M
U
U
a
n
a
a
a
a
a
a
a
a
m
a
m
m
a
a
a
a
a
a
a
a
a
a
a
a
a
a
a
a
a
a
a
a
a
m
a
a
m
a
m
a
a
a
a
a
a
m
a
m
a
U
M
M
M
M
M
M
M
"}
(27,1,1) = {"
M
M
M
M
M
M
M
M
M
M
M
M
M
M
M
U
a
n
m
a
a
a
a
a
a
a
a
a
a
a
a
a
a
a
a
a
a
a
a
a
a
a
a
a
a
a
a
a
a
a
a
m
a
a
m
a
m
a
a
a
a
m
a
m
n
m
a
U
M
M
M
M
M
M
M
"}
(28,1,1) = {"
M
M
M
M
M
M
M
M
M
M
M
M
M
M
M
U
a
m
a
a
a
a
a
a
a
a
a
a
a
a
a
a
a
a
a
a
a
a
a
a
a
a
a
a
a
a
a
a
m
a
a
a
a
a
a
n
a
a
a
m
a
a
m
a
m
a
a
U
M
M
M
M
M
M
M
"}
(29,1,1) = {"
M
M
M
M
M
M
M
M
M
M
M
M
M
M
M
U
a
m
n
a
a
a
a
a
a
m
n
a
m
m
a
m
a
a
a
a
a
a
a
a
a
a
a
a
a
m
a
a
m
a
a
m
a
a
a
m
a
a
a
a
a
a
m
a
n
m
a
U
M
M
M
M
M
M
M
"}
(30,1,1) = {"
M
M
M
M
M
M
M
M
M
M
M
M
M
M
M
U
a
a
n
a
a
a
a
a
m
a
a
m
a
a
a
a
m
a
a
a
a
a
a
a
a
a
a
a
m
m
a
a
m
a
a
m
a
a
m
a
m
a
a
a
a
a
a
m
n
m
a
U
M
M
M
M
M
M
M
"}
(31,1,1) = {"
M
M
M
M
M
M
M
M
M
M
U
U
U
U
U
U
a
a
n
m
a
a
a
a
m
m
a
m
a
a
a
a
a
a
a
a
a
a
a
a
a
a
a
a
a
a
a
a
a
a
m
a
a
a
a
a
a
a
a
a
a
a
a
m
m
m
a
U
M
M
M
M
M
M
M
"}
(32,1,1) = {"
M
M
M
M
M
M
M
M
M
M
U
a
K
K
a
a
a
a
m
m
a
a
a
a
a
a
m
a
a
a
a
a
a
a
a
m
m
a
a
a
a
a
a
a
a
a
a
a
m
a
a
m
a
a
m
a
a
a
a
a
a
a
a
a
m
a
a
U
M
M
M
M
M
M
M
"}
(33,1,1) = {"
M
M
M
M
M
M
M
M
M
M
U
R
k
t
a
a
a
a
a
m
a
a
a
a
a
m
a
a
a
a
a
a
a
a
a
a
m
m
a
a
a
a
m
m
a
a
m
a
a
a
a
m
a
a
m
a
a
a
a
a
a
a
a
a
a
a
a
U
M
M
M
M
M
M
M
"}
(34,1,1) = {"
M
M
M
M
M
M
M
M
M
M
U
R
E
Z
a
a
a
a
m
a
a
a
a
a
a
a
a
a
a
m
m
a
a
a
a
a
a
m
m
a
a
a
a
a
m
m
m
a
a
a
a
a
a
a
a
a
a
a
a
a
a
a
a
a
a
a
a
U
M
M
M
M
M
M
M
"}
(35,1,1) = {"
M
M
M
M
M
M
M
M
M
M
U
Q
T
G
a
a
a
a
m
a
a
a
a
a
a
a
a
a
a
a
a
m
a
a
a
a
a
a
m
m
a
a
m
a
a
a
a
a
a
a
a
a
a
a
a
a
a
a
a
a
m
a
a
m
a
m
a
U
M
M
M
M
M
M
M
"}
(36,1,1) = {"
M
M
M
M
M
M
M
M
M
M
U
a
I
I
a
a
a
a
a
m
a
a
a
a
a
a
a
a
a
a
a
a
m
a
a
a
a
a
a
m
a
a
a
a
a
a
a
a
a
m
a
a
a
a
a
a
a
a
a
a
a
m
a
m
a
m
a
U
M
M
M
M
M
M
M
"}
(37,1,1) = {"
M
M
M
M
M
M
M
M
M
M
U
U
U
U
U
U
a
a
m
n
a
a
a
a
a
a
a
a
a
a
a
a
a
m
a
a
a
a
a
a
m
m
a
a
a
a
a
a
a
a
a
a
a
a
a
a
a
a
a
a
a
m
a
a
a
a
a
U
M
M
M
M
M
M
M
"}
(38,1,1) = {"
M
M
M
M
M
M
M
M
M
M
M
M
M
M
M
U
a
m
n
m
a
a
a
a
a
a
a
a
a
a
a
a
a
m
m
a
a
a
a
a
a
n
a
a
a
a
a
a
a
a
a
a
a
a
a
m
a
a
a
a
m
a
a
a
a
a
a
U
M
M
M
M
M
M
M
"}
(39,1,1) = {"
M
M
M
M
M
M
M
M
M
M
M
M
M
M
M
U
a
m
a
a
a
a
a
a
a
a
a
a
a
a
a
a
a
a
a
a
a
a
a
a
a
a
m
a
a
a
a
a
a
a
a
a
a
a
a
m
a
a
a
a
m
a
a
m
m
a
a
U
M
M
M
M
M
M
M
"}
(40,1,1) = {"
M
M
M
M
M
M
M
M
M
M
M
M
M
M
M
U
a
a
a
n
a
a
a
a
a
a
a
a
a
a
a
a
a
a
a
a
a
a
a
a
m
a
a
m
m
a
a
a
a
a
a
a
a
a
a
a
a
a
a
a
m
a
a
a
m
m
a
U
M
M
M
M
M
M
M
"}
(41,1,1) = {"
M
M
M
M
M
M
M
M
M
M
M
M
M
M
M
U
a
a
a
a
a
a
a
a
a
a
a
a
a
a
a
a
a
a
a
a
m
a
a
m
m
a
a
a
m
a
a
a
m
a
a
a
a
a
m
a
a
a
a
a
m
a
a
a
a
m
a
U
M
M
M
M
M
M
M
"}
(42,1,1) = {"
M
M
M
M
M
M
M
M
M
M
M
M
M
M
M
U
a
a
a
n
a
a
a
a
a
a
m
a
a
a
a
a
a
a
a
a
a
a
a
m
a
a
a
a
a
m
a
a
a
a
a
a
a
a
m
a
a
a
a
a
m
a
a
a
a
m
a
U
M
M
M
M
M
M
M
"}
(43,1,1) = {"
M
M
M
M
M
M
M
M
M
M
M
M
M
M
M
U
a
a
a
m
m
a
a
a
m
m
a
a
a
a
a
a
a
a
a
a
a
a
a
a
a
a
a
a
m
m
a
a
a
a
a
a
a
m
m
a
a
a
a
a
m
a
a
m
a
m
a
U
M
M
M
M
M
M
M
"}
(44,1,1) = {"
M
M
M
M
M
M
M
M
M
M
M
M
M
M
M
U
a
a
a
n
m
a
a
a
m
a
a
a
a
a
a
a
a
a
a
a
a
a
a
a
a
a
a
a
m
a
a
a
a
a
a
a
a
m
a
a
a
a
a
a
a
a
a
a
a
m
a
U
M
M
M
M
M
M
M
"}
(45,1,1) = {"
M
M
M
M
M
M
M
M
M
M
M
M
M
M
M
U
a
a
n
n
a
a
a
m
a
m
a
a
a
a
a
a
a
a
a
a
a
a
a
a
a
a
a
a
m
a
a
a
a
a
a
a
a
m
a
a
a
a
a
a
a
a
a
a
a
m
a
U
M
M
M
M
M
M
M
"}
(46,1,1) = {"
M
M
M
M
M
M
M
M
M
M
M
M
M
M
M
U
a
a
n
a
a
a
a
m
a
a
m
a
a
a
a
a
a
a
a
a
a
a
a
a
a
a
a
a
a
a
a
a
a
a
a
a
a
m
a
a
a
a
a
a
a
a
a
a
a
a
a
U
M
M
M
M
M
M
M
"}
(47,1,1) = {"
M
M
M
M
M
M
M
M
M
M
M
M
M
M
M
U
a
a
m
a
a
a
a
a
m
a
a
m
a
a
a
a
a
a
a
a
a
a
a
a
a
a
a
a
m
a
a
a
a
a
a
a
a
a
a
a
a
a
a
a
a
a
a
a
a
a
a
U
M
M
M
M
M
M
M
"}
(48,1,1) = {"
M
M
M
M
M
M
M
M
M
M
M
M
M
M
M
U
a
a
m
a
a
a
a
a
m
a
a
a
m
a
a
a
a
a
a
a
a
a
a
a
a
m
m
a
a
a
a
a
a
a
a
a
a
a
a
a
a
a
a
a
a
a
a
m
m
m
a
U
M
M
M
M
M
M
M
"}
(49,1,1) = {"
M
M
M
M
M
M
M
M
M
M
M
M
M
M
M
U
a
a
a
a
a
a
a
a
a
a
a
a
a
m
a
a
a
a
a
a
a
a
a
a
a
a
m
a
a
a
a
a
a
a
a
a
a
a
a
a
m
m
a
a
a
a
a
a
a
n
a
U
M
M
M
M
M
M
M
"}
(50,1,1) = {"
M
M
M
M
M
M
M
M
M
M
M
M
M
M
M
U
a
a
m
m
a
a
a
m
a
a
a
a
a
a
a
a
a
a
a
a
a
a
a
a
a
a
a
a
a
a
a
a
a
a
a
a
a
a
a
a
a
a
a
a
a
a
a
a
a
n
a
U
M
M
M
M
M
M
M
"}
(51,1,1) = {"
M
M
M
M
M
M
M
M
M
M
M
M
M
M
M
U
a
a
a
m
a
a
a
a
a
a
m
m
m
a
a
a
a
a
a
m
a
a
a
a
a
a
a
a
m
a
a
a
a
a
a
a
a
a
a
a
a
a
a
a
a
a
a
a
a
a
a
U
M
M
M
M
M
M
M
"}
(52,1,1) = {"
M
M
M
M
M
M
M
M
M
M
M
M
M
M
M
U
a
a
m
m
a
a
m
m
a
a
a
a
a
a
a
a
a
a
a
a
m
m
a
a
a
a
a
a
m
a
a
a
m
n
m
m
a
a
a
a
a
a
a
a
a
m
m
a
a
a
a
U
M
M
M
M
M
M
M
"}
(53,1,1) = {"
M
M
M
M
M
M
M
M
M
M
M
M
M
M
M
U
a
a
m
m
a
a
a
a
a
m
a
a
a
a
a
a
a
a
a
a
a
a
a
a
m
m
a
m
a
m
m
a
a
a
a
a
a
a
a
a
a
a
a
a
m
a
a
n
m
m
a
U
M
M
M
M
M
M
M
"}
(54,1,1) = {"
M
M
M
M
M
M
M
M
M
M
M
M
M
M
M
U
a
m
a
a
a
a
a
a
a
a
a
m
a
a
a
m
m
a
a
a
a
a
m
a
m
m
a
a
a
a
a
a
a
a
a
a
a
a
a
a
a
a
a
a
a
a
m
a
a
m
a
U
M
M
M
M
M
M
M
"}
(55,1,1) = {"
M
M
M
M
M
M
M
M
M
M
M
M
M
M
M
U
a
m
a
m
a
a
a
a
a
a
a
a
m
m
a
a
m
a
a
a
a
a
a
a
a
a
a
a
m
a
a
a
a
a
a
a
a
a
a
a
a
a
a
a
a
m
m
a
a
a
a
U
M
M
M
M
M
M
M
"}
(56,1,1) = {"
M
M
M
M
M
M
M
M
M
M
M
M
M
M
M
U
a
a
m
a
a
a
a
a
a
a
a
a
a
a
a
m
m
a
a
a
a
a
a
a
a
a
a
a
m
a
a
a
a
a
a
a
a
a
m
m
a
a
a
a
a
m
a
m
n
m
a
U
M
M
M
M
M
M
M
"}
(57,1,1) = {"
M
M
M
M
M
M
M
M
M
M
M
M
M
M
M
U
a
a
m
a
a
a
a
a
a
a
a
a
a
a
a
a
a
a
a
a
a
a
a
a
a
a
a
a
a
a
a
a
a
m
m
a
a
a
a
a
a
a
a
a
a
a
a
a
m
m
a
U
M
M
M
M
M
M
M
"}
(58,1,1) = {"
M
M
M
M
M
M
M
M
M
M
M
M
M
M
M
U
a
a
a
a
m
m
m
a
a
a
a
m
a
a
a
a
a
a
a
a
a
a
a
a
a
a
a
a
a
a
a
a
a
a
n
a
m
m
m
a
a
a
a
a
m
a
a
a
m
a
a
U
M
M
M
M
M
M
M
"}
(59,1,1) = {"
M
M
M
M
M
M
M
M
M
M
M
M
M
M
M
U
a
m
a
m
a
a
a
m
m
m
a
a
a
a
a
a
a
a
a
a
a
a
a
m
a
m
m
m
n
a
a
a
a
a
m
m
a
a
a
a
a
a
a
a
a
a
a
a
m
a
a
U
M
M
M
M
M
M
M
"}
(60,1,1) = {"
M
M
M
M
M
M
M
M
M
M
M
M
M
M
M
U
a
m
a
m
a
a
a
a
a
a
a
a
a
a
a
a
a
a
a
a
a
a
a
a
a
a
a
a
a
a
a
a
a
a
a
a
a
a
a
a
a
a
a
a
a
a
a
a
a
a
a
U
M
M
M
M
M
M
M
"}
(61,1,1) = {"
M
M
M
M
M
M
M
M
M
M
M
M
M
M
M
U
a
a
a
m
a
a
a
a
a
a
a
a
a
a
a
a
a
a
a
a
a
a
a
a
a
a
a
a
a
a
a
a
a
a
a
a
a
a
a
a
a
a
a
a
a
a
a
a
m
m
a
U
M
M
M
M
M
M
M
"}
(62,1,1) = {"
M
M
M
M
M
M
M
M
M
M
M
M
M
M
M
U
a
a
m
a
a
a
a
a
a
a
a
a
a
a
a
a
a
a
a
a
a
a
a
a
a
a
a
a
a
a
a
a
a
a
a
a
a
a
a
a
a
a
a
a
a
a
a
a
m
m
a
U
M
M
M
M
M
M
M
"}
(63,1,1) = {"
M
M
M
M
M
M
M
M
M
M
M
M
M
M
M
U
a
a
m
a
a
a
a
a
a
a
a
a
a
a
a
a
a
a
a
a
a
a
a
a
a
a
a
a
a
a
a
a
a
a
a
a
a
a
a
a
a
a
a
a
a
a
a
a
a
a
a
U
M
M
M
M
M
M
M
"}
(64,1,1) = {"
M
M
M
M
M
M
M
M
M
M
M
M
M
M
M
U
a
a
a
m
a
a
a
a
a
a
a
m
a
a
a
a
a
a
a
a
a
a
a
a
a
a
a
a
a
a
a
a
a
a
a
a
a
a
a
a
a
a
a
a
a
m
a
a
a
a
a
U
M
M
M
M
M
M
M
"}
(65,1,1) = {"
M
M
M
M
M
M
M
M
M
M
M
M
M
M
M
U
a
a
a
m
a
a
a
a
a
m
m
a
a
a
a
a
a
a
a
a
a
a
a
a
a
a
a
a
a
a
a
a
a
a
a
a
a
a
a
a
a
a
a
a
a
m
a
a
a
a
a
U
M
M
M
M
M
M
M
"}
(66,1,1) = {"
M
M
M
M
M
M
M
M
M
M
M
M
M
M
M
U
a
a
m
m
a
a
a
a
a
a
a
a
a
a
a
a
a
a
a
a
a
a
a
a
a
a
a
a
a
a
a
a
a
a
a
a
a
a
a
a
a
a
a
a
a
a
a
m
a
a
a
U
M
M
M
M
M
M
M
"}
(67,1,1) = {"
M
M
M
M
M
M
M
M
M
M
M
M
M
M
M
U
a
a
m
a
a
a
a
a
a
a
a
a
a
a
a
a
a
a
a
a
a
a
a
a
a
a
a
a
a
a
a
a
a
a
a
a
a
a
a
a
a
a
a
a
m
a
a
a
m
a
a
U
M
M
M
M
M
M
M
"}
(68,1,1) = {"
M
M
M
M
M
M
M
M
M
M
M
M
M
M
M
U
a
m
m
a
a
a
a
a
a
a
a
a
a
a
a
a
a
a
a
a
a
a
a
a
a
a
a
a
a
a
a
a
a
a
a
a
a
a
a
a
a
a
m
n
m
a
a
a
a
m
a
U
M
M
M
M
M
M
M
"}
(69,1,1) = {"
M
M
M
M
M
M
M
M
M
M
M
M
M
M
M
U
a
n
a
a
a
a
a
a
a
a
a
a
a
a
a
a
a
a
a
a
a
a
a
a
a
a
a
a
a
a
a
a
a
a
a
a
m
a
a
n
m
m
n
a
a
a
a
a
a
m
a
U
M
M
M
M
M
M
M
"}
(70,1,1) = {"
M
M
M
M
M
M
M
M
M
M
M
M
M
M
M
U
a
m
a
a
a
a
a
a
a
a
a
a
a
a
a
a
a
a
a
a
a
a
a
a
a
a
a
a
a
a
a
a
a
a
a
a
a
a
a
a
n
m
a
a
a
a
a
a
n
m
a
U
M
M
M
M
M
M
M
"}
(71,1,1) = {"
M
M
M
M
M
M
M
M
M
M
M
M
M
M
M
U
a
m
a
a
a
a
a
a
a
a
a
a
a
a
a
a
a
a
a
a
a
a
a
a
a
a
a
a
a
a
a
a
a
a
a
a
a
a
a
a
m
a
a
a
a
a
a
m
a
a
a
U
M
M
M
M
M
M
M
"}
(72,1,1) = {"
M
M
M
M
M
M
M
M
M
M
M
M
M
M
M
U
a
m
a
a
a
a
a
a
a
a
a
a
a
a
a
a
a
a
a
a
a
a
a
a
a
a
a
a
a
a
a
a
a
a
a
a
a
a
a
a
m
a
a
a
a
a
m
a
m
m
m
U
M
M
M
M
M
M
M
"}
(73,1,1) = {"
M
M
M
M
M
M
M
M
M
M
M
M
M
M
M
U
a
m
a
a
m
a
a
a
a
a
a
a
m
m
a
a
m
m
a
m
a
m
a
a
a
a
a
a
a
a
a
a
a
a
a
a
a
a
a
m
a
a
a
a
a
a
a
a
a
a
a
U
M
M
M
M
M
M
M
"}
(74,1,1) = {"
M
M
M
M
M
M
M
M
M
M
M
M
M
M
M
U
a
a
a
a
m
a
a
a
a
a
a
a
a
a
a
a
a
a
a
a
a
a
a
a
a
a
a
a
a
a
a
a
a
a
a
a
a
a
m
a
a
a
a
a
a
a
a
a
m
a
a
U
M
M
M
M
M
M
M
"}
(75,1,1) = {"
M
M
M
M
M
M
M
M
M
M
M
M
M
M
M
U
a
a
a
a
m
a
a
a
a
a
a
a
a
a
a
a
a
a
a
a
a
a
a
a
a
a
a
a
a
a
a
a
a
a
a
a
m
m
a
a
a
a
a
a
a
a
a
a
a
m
a
U
M
M
M
M
M
M
M
"}
(76,1,1) = {"
M
M
M
M
M
M
M
M
M
M
M
M
M
M
M
U
a
a
a
m
a
a
a
a
a
a
a
a
a
a
a
a
a
a
a
a
a
a
a
a
a
a
a
m
a
m
m
a
m
a
a
a
a
a
a
a
a
a
a
a
a
a
a
a
a
m
a
U
M
M
M
M
M
M
M
"}
(77,1,1) = {"
M
M
M
M
M
M
M
M
M
M
M
M
M
M
M
U
a
a
a
a
a
a
a
a
a
a
a
a
a
a
a
a
a
a
a
a
a
a
a
a
m
m
m
a
a
a
a
a
a
a
a
a
a
a
a
a
a
a
a
a
a
a
a
a
a
a
m
U
M
M
M
M
M
M
M
"}
(78,1,1) = {"
M
M
M
M
M
M
M
M
M
M
M
M
M
M
M
U
a
a
a
m
m
a
a
a
a
a
a
a
a
a
a
a
a
a
a
a
a
a
a
a
a
a
a
a
a
a
a
a
a
a
a
m
a
a
m
a
a
a
a
a
a
a
a
a
a
m
a
U
M
M
M
M
M
M
M
"}
(79,1,1) = {"
M
M
M
M
M
M
M
M
M
M
M
M
M
M
M
U
a
a
m
m
n
m
m
a
a
m
m
a
a
a
a
a
a
m
a
a
a
a
a
a
a
a
a
a
n
a
a
a
a
m
m
m
a
a
a
m
a
m
a
m
m
m
a
a
m
a
a
U
M
M
M
M
M
M
M
"}
(80,1,1) = {"
M
M
M
M
M
M
M
M
M
M
M
M
M
M
M
U
a
a
a
m
m
m
a
a
a
m
n
a
a
a
a
m
a
m
m
a
a
m
a
a
a
a
a
a
a
a
a
n
a
a
a
m
a
a
a
m
a
m
a
m
m
n
m
n
a
a
a
U
M
M
M
M
M
M
M
"}
(81,1,1) = {"
M
M
M
M
M
M
M
M
M
M
M
M
M
M
M
U
a
a
a
a
a
a
a
a
a
a
a
a
m
a
a
a
a
a
a
a
a
m
m
a
a
a
a
m
m
n
a
a
a
a
m
m
a
a
a
a
m
m
m
a
m
a
m
m
a
a
a
U
M
M
M
M
M
M
M
"}
(82,1,1) = {"
M
M
M
M
M
M
M
M
M
M
M
M
M
M
M
U
a
a
a
a
a
a
a
a
a
a
a
a
a
m
a
a
a
a
a
a
a
a
a
a
a
a
m
a
a
a
a
a
a
a
a
a
a
a
a
m
a
a
a
a
a
a
a
a
a
a
a
U
M
M
M
M
M
M
M
"}
(83,1,1) = {"
M
M
M
M
M
M
M
M
M
M
M
M
M
M
M
U
U
U
U
U
U
U
U
U
U
U
U
U
U
W
U
U
U
U
U
U
U
U
U
U
U
U
U
U
U
U
U
U
U
U
U
U
U
U
U
U
U
U
U
U
U
U
U
U
U
U
U
U
M
M
M
M
M
M
M
"}
(84,1,1) = {"
M
M
M
M
M
M
M
M
M
M
M
M
M
M
M
M
M
M
M
M
M
M
M
M
M
M
M
M
M
M
M
M
M
M
M
M
M
M
M
M
M
M
M
M
M
M
M
M
M
M
M
M
M
M
M
M
M
M
M
M
M
M
M
M
M
M
M
M
M
M
M
M
M
M
M
"}
(85,1,1) = {"
M
M
M
M
M
M
M
M
M
M
M
M
M
M
M
M
M
M
M
M
M
M
M
M
M
M
M
M
M
M
M
M
M
M
M
M
M
M
M
M
M
M
M
M
M
M
M
M
M
M
M
M
M
M
M
M
M
M
M
M
M
M
M
M
M
M
M
M
M
M
M
M
M
M
M
"}
(86,1,1) = {"
M
M
M
M
M
M
M
M
M
M
M
M
M
M
M
M
M
M
M
M
M
M
M
M
M
M
M
M
M
M
M
M
M
M
M
M
M
M
M
M
M
M
M
M
M
M
M
M
M
M
M
M
M
M
M
M
M
M
M
M
M
M
M
M
M
M
M
M
M
M
M
M
M
M
M
"}
(87,1,1) = {"
M
M
M
M
M
M
M
M
M
M
M
M
M
M
M
M
M
M
M
M
M
M
M
M
M
M
M
M
M
M
M
M
M
M
M
M
M
M
M
M
M
M
M
M
M
M
M
M
M
M
M
M
M
M
M
M
M
M
M
M
M
M
M
M
M
M
M
M
M
M
M
M
M
M
M
"}
(88,1,1) = {"
M
M
M
M
M
M
M
M
M
M
M
M
M
M
M
M
M
M
M
M
M
M
M
M
M
M
M
M
M
M
M
M
M
M
M
M
M
M
M
M
M
M
M
M
M
M
M
M
M
M
M
M
M
M
M
M
M
M
M
M
M
M
M
M
M
M
M
M
M
M
M
M
M
M
M
"}
(89,1,1) = {"
M
M
M
M
M
M
M
M
M
M
M
M
M
M
M
M
M
M
M
M
M
M
M
M
M
M
M
M
M
M
M
M
M
M
M
M
M
M
M
M
M
M
M
M
M
M
M
M
M
M
M
M
M
M
M
M
M
M
M
M
M
M
M
M
M
M
M
M
M
M
M
M
M
M
M
"}
(90,1,1) = {"
M
M
M
M
M
M
M
M
M
M
M
M
M
M
M
M
M
M
M
M
M
M
M
M
M
M
M
M
M
M
M
M
M
M
M
M
M
M
M
M
M
M
M
M
M
M
M
M
M
M
M
M
M
M
M
M
M
M
M
M
M
M
M
M
M
M
M
M
M
M
M
M
M
M
M
"}
