//MAP CONVERTED BY dmm2tgm.py THIS HEADER COMMENT PREVENTS RECONVERSION, DO NOT REMOVE
"a" = (
/obj/effect/dummy/lighting_obj{
	light_range = 10
	},
/turf/open/floor/glass/cyan,
/area/hangar)
"i" = (
/obj/effect/landmark/outpost/elevator,
/turf/open/floor/plasteel/elevatorshaft{
	planetary_atmos = 1
	},
/area/hangar)
"m" = (
/obj/effect/dummy/lighting_obj{
	light_range = 10
	},
/obj/effect/dummy/lighting_obj{
	light_range = 10
	},
/turf/open/floor/glass/cyan,
/area/hangar)
"n" = (
/obj/effect/dummy/lighting_obj{
	light_range = 10
	},
/obj/effect/dummy/lighting_obj{
	light_range = 10
	},
/obj/effect/dummy/lighting_obj{
	light_range = 10
	},
/turf/open/floor/glass/cyan,
/area/hangar)
"o" = (
/turf/closed/indestructible/reinforced,
/area/hangar)
"q" = (
/turf/open/space/anima,
/area/template_noop)
"v" = (
/obj/effect/landmark/outpost/elevator_machine,
/obj/machinery/elevator_call_button{
	pixel_y = 31;
	pixel_x = 10
	},
/turf/open/floor/glass/cyan,
/area/hangar)
"y" = (
/obj/effect/landmark/outpost/shaft_number,
/turf/open/floor/glass/cyan,
/area/hangar)
"z" = (
/turf/open/floor/plasteel/elevatorshaft{
	planetary_atmos = 1
	},
/area/hangar)
"B" = (
/obj/machinery/door/airlock,
/obj/effect/landmark/outpost/elevator_machine,
/turf/open/floor/glass/cyan,
/area/hangar)
"J" = (
/turf/open/floor/glass/cyan,
/area/hangar)
"M" = (
/turf/open/space/basic,
/area/template_noop)
"S" = (
/obj/effect/landmark/outpost/hangar_dock,
/obj/effect/dummy/lighting_obj{
	light_range = 10
	},
/turf/open/floor/glass/cyan,
/area/hangar)
"U" = (
/obj/structure/window/reinforced/fulltile/indestructible{
	alpha = 0
	},
/turf/open/space/basic,
/area/hangar)
"W" = (
/obj/structure/window/reinforced/fulltile/indestructible{
	alpha = 0
	},
/obj/effect/dummy/lighting_obj{
	light_range = 10
	},
/turf/open/space/basic,
/area/hangar)
"Y" = (
/obj/effect/landmark/outpost/hangar_numbers,
/turf/open/floor/glass/cyan,
/area/hangar)

(1,1,1) = {"
M
M
M
M
M
M
M
M
M
M
M
M
M
M
M
M
M
M
M
M
M
M
M
M
M
M
M
M
M
M
M
M
M
M
M
M
M
M
M
M
M
M
M
M
M
M
M
M
M
M
M
M
M
M
M
M
M
M
M
M
M
M
M
M
M
M
M
M
M
M
"}
(2,1,1) = {"
M
M
M
M
M
M
M
M
M
M
M
M
M
M
M
M
M
M
M
M
M
M
M
M
M
M
M
M
M
M
M
M
M
M
M
M
M
M
M
M
M
M
M
M
M
M
M
M
M
M
M
M
M
M
M
M
M
M
M
M
M
M
M
M
M
M
M
M
M
M
"}
(3,1,1) = {"
M
M
M
M
M
M
M
M
M
M
M
M
M
M
M
M
M
M
M
M
M
M
M
M
M
M
M
M
M
M
M
M
M
M
M
M
M
M
M
M
M
M
M
M
M
M
M
M
M
M
M
M
M
M
M
M
M
M
M
M
M
M
M
M
M
M
M
M
M
M
"}
(4,1,1) = {"
M
M
M
M
M
M
M
M
M
M
M
M
M
M
M
M
M
M
M
M
M
M
M
M
M
M
M
M
M
M
M
M
M
M
M
M
M
M
M
M
M
M
M
M
M
M
M
M
M
M
M
M
M
M
M
M
M
M
M
M
M
M
M
M
M
M
M
M
M
M
"}
(5,1,1) = {"
M
M
M
M
M
M
M
M
M
M
M
M
M
M
M
M
M
M
M
M
M
M
M
M
M
M
M
M
M
M
M
M
M
M
M
M
M
M
M
M
M
M
M
M
M
M
M
M
M
M
M
M
M
M
M
M
M
M
M
M
M
M
M
M
M
M
M
M
M
M
"}
(6,1,1) = {"
M
M
M
M
M
M
M
M
M
M
M
M
M
M
M
M
M
M
M
M
M
M
M
M
M
M
M
M
M
M
M
M
M
M
M
M
M
M
M
M
M
M
M
M
M
M
M
M
M
M
M
M
M
M
M
M
M
M
M
M
M
M
M
M
M
M
M
M
M
M
"}
(7,1,1) = {"
M
M
M
M
M
M
M
M
M
M
M
M
M
M
M
M
M
M
M
M
M
M
M
M
M
M
M
M
M
M
M
M
M
M
M
M
M
M
M
M
M
M
M
M
M
M
M
M
M
M
M
M
M
M
M
M
M
M
M
M
M
M
M
M
M
M
M
M
M
M
"}
(8,1,1) = {"
M
M
M
M
M
M
M
M
M
M
M
M
M
M
M
M
M
M
M
M
M
M
M
M
M
M
M
M
M
M
M
M
M
M
M
M
M
M
M
M
M
M
M
M
M
M
M
M
M
M
M
M
M
M
M
M
M
M
M
M
M
M
M
M
M
M
M
M
M
M
"}
(9,1,1) = {"
M
M
M
M
M
M
M
M
M
M
U
U
U
U
U
U
U
U
U
U
U
U
U
U
U
U
U
U
U
U
U
U
U
U
U
U
U
U
U
U
U
U
U
U
U
U
U
U
U
U
U
U
U
U
U
U
U
U
U
U
U
U
U
M
M
M
M
M
M
M
"}
(10,1,1) = {"
M
M
M
M
M
M
M
M
M
M
U
a
a
a
a
a
a
a
a
a
a
a
a
a
a
a
a
a
a
a
a
a
a
a
a
a
a
a
a
a
a
a
a
a
a
a
a
a
a
a
a
a
a
a
a
a
a
a
a
a
a
a
U
M
M
M
M
M
M
M
"}
(11,1,1) = {"
M
M
M
M
M
M
M
M
M
M
U
a
a
a
a
a
a
a
a
a
a
a
a
a
a
a
m
m
m
m
a
a
a
a
a
a
a
a
a
a
a
a
a
a
a
a
a
a
a
a
a
a
a
a
a
a
a
a
a
a
a
a
U
M
M
M
M
M
M
M
"}
(12,1,1) = {"
M
M
M
M
q
q
q
q
q
M
U
a
a
a
a
a
a
a
a
a
a
a
a
a
m
m
a
a
a
a
a
a
a
a
a
a
a
a
a
m
a
a
a
n
a
a
a
m
a
a
a
m
a
a
a
m
a
a
a
m
a
a
U
M
M
M
M
M
M
M
"}
(13,1,1) = {"
M
M
M
M
q
q
q
q
q
M
U
a
a
a
m
a
a
a
a
a
a
a
a
a
m
m
m
a
a
a
a
a
a
a
a
a
a
a
a
a
a
m
m
m
m
m
a
a
a
a
a
a
a
a
a
a
a
a
a
a
a
a
U
M
M
M
M
M
M
M
"}
(14,1,1) = {"
M
M
M
M
q
q
q
q
q
M
U
a
a
a
a
a
a
a
a
a
a
a
a
a
a
a
a
a
a
a
a
a
m
m
m
m
a
a
a
a
a
a
a
a
a
a
a
a
a
a
a
a
a
a
a
a
a
S
a
a
a
a
U
M
M
M
M
M
M
M
"}
(15,1,1) = {"
M
M
M
M
q
q
q
q
q
M
U
a
a
a
m
a
a
a
a
a
a
a
a
a
a
a
a
a
a
a
a
a
a
a
a
a
a
a
a
a
a
a
a
a
a
a
a
a
a
a
a
a
a
a
a
a
a
a
a
a
a
a
U
M
M
M
M
M
M
M
"}
(16,1,1) = {"
M
M
M
M
M
M
M
M
M
M
U
a
a
a
m
a
a
a
a
a
a
a
a
a
a
a
a
a
a
a
a
a
a
a
a
a
a
a
a
m
a
a
a
a
a
a
a
a
a
a
a
a
a
a
a
a
a
a
a
m
a
a
U
M
M
M
M
M
M
M
"}
(17,1,1) = {"
M
M
M
M
M
M
M
M
M
M
U
a
a
a
m
a
a
a
a
a
a
a
a
m
m
a
a
a
a
a
a
a
a
a
a
a
a
a
a
a
a
a
a
a
a
a
a
a
m
a
a
a
a
a
a
m
a
a
a
a
a
a
U
M
M
M
M
M
M
M
"}
(18,1,1) = {"
M
M
M
M
M
M
M
M
M
M
U
a
a
m
a
a
a
a
a
a
a
a
m
a
a
m
a
a
a
a
a
a
a
a
m
a
m
a
a
a
a
a
a
a
a
a
a
m
m
a
a
a
a
m
m
m
m
m
a
a
a
a
U
M
M
M
M
M
M
M
"}
(19,1,1) = {"
M
M
M
M
M
M
M
M
M
M
U
a
m
m
a
a
a
a
a
a
a
a
a
a
a
a
m
a
a
m
a
a
a
a
a
a
a
a
a
a
a
a
a
a
a
a
a
a
a
n
a
m
a
a
a
a
a
a
m
a
a
a
U
M
M
M
M
M
M
M
"}
(20,1,1) = {"
M
M
M
M
M
M
M
M
M
U
U
a
m
a
a
a
a
a
a
a
a
a
a
a
m
a
a
a
a
a
a
a
a
a
a
a
a
a
m
m
a
a
a
a
a
a
a
a
a
a
a
a
m
a
a
a
a
a
a
m
a
a
U
M
M
M
M
M
M
M
"}
(21,1,1) = {"
M
M
M
M
o
o
o
o
o
v
J
a
a
a
a
a
a
a
a
a
a
a
a
a
a
a
a
m
a
a
a
a
a
a
a
a
a
a
a
m
m
a
a
a
a
a
a
a
m
a
m
a
m
a
a
a
a
a
a
a
a
a
U
M
M
M
M
M
M
M
"}
(22,1,1) = {"
M
M
M
M
o
z
z
i
B
a
J
a
m
a
a
a
a
a
a
a
a
a
a
m
a
a
a
a
m
a
a
a
a
a
a
a
a
a
a
a
m
m
a
a
a
a
a
m
a
a
a
a
m
a
a
a
a
a
a
a
a
a
U
M
M
M
M
M
M
M
"}
(23,1,1) = {"
M
M
M
M
o
z
z
z
B
J
y
a
m
a
a
a
a
m
a
a
a
a
m
a
a
a
a
a
m
a
a
a
a
a
a
a
a
a
a
a
a
a
a
a
a
a
a
a
m
a
a
a
a
a
a
a
a
a
a
a
a
a
U
M
M
M
M
M
M
M
"}
(24,1,1) = {"
M
M
M
M
o
z
z
z
B
a
Y
a
a
a
m
a
a
a
a
m
m
a
m
a
a
a
a
a
m
a
a
a
a
a
a
a
a
a
a
m
a
a
a
a
a
a
a
a
a
m
a
a
a
a
a
a
a
a
a
m
a
a
U
M
M
M
M
M
M
M
"}
(25,1,1) = {"
M
M
M
M
o
o
o
o
o
J
J
a
a
m
a
a
a
a
a
a
a
m
m
m
a
a
a
a
a
a
a
a
a
a
a
a
a
a
a
a
a
a
a
a
a
a
a
a
a
a
m
a
a
a
a
a
a
m
a
a
a
a
U
M
M
M
M
M
M
M
"}
(26,1,1) = {"
M
M
M
M
M
M
M
M
M
U
U
a
n
a
a
a
a
a
a
a
a
m
a
m
m
a
a
a
a
a
a
a
a
a
a
a
a
a
a
a
a
a
a
a
a
a
m
a
a
m
a
m
a
a
a
a
a
a
m
a
m
a
U
M
M
M
M
M
M
M
"}
(27,1,1) = {"
M
M
M
M
M
M
M
M
M
M
U
a
n
m
a
a
a
a
a
a
a
a
a
a
a
a
a
a
a
a
a
a
a
a
a
a
a
a
a
a
a
a
a
a
a
a
m
a
a
m
a
m
a
a
a
a
m
a
m
n
m
a
U
M
M
M
M
M
M
M
"}
(28,1,1) = {"
M
M
M
M
M
M
M
M
M
M
U
a
m
a
a
a
a
a
a
a
a
a
a
a
a
a
a
a
a
a
a
a
a
a
a
a
a
a
a
a
a
a
a
m
a
a
a
a
a
a
n
a
a
a
m
a
a
m
a
m
a
a
U
M
M
M
M
M
M
M
"}
(29,1,1) = {"
M
M
M
M
M
M
M
M
M
M
U
a
m
n
a
a
a
a
a
a
m
n
a
m
m
a
m
a
a
a
a
a
a
a
a
a
a
a
a
a
m
a
a
m
a
a
m
a
a
a
m
a
a
a
a
a
a
m
a
n
m
a
U
M
M
M
M
M
M
M
"}
(30,1,1) = {"
M
M
M
M
M
M
M
M
M
M
U
a
a
n
a
a
a
a
a
m
a
a
m
a
a
a
a
m
a
a
a
a
a
a
a
a
a
a
a
m
m
a
a
m
a
a
m
a
a
m
a
m
a
a
a
a
a
a
m
n
m
a
U
M
M
M
M
M
M
M
"}
(31,1,1) = {"
M
M
M
M
M
M
M
M
M
M
U
a
a
n
m
a
a
a
a
m
m
a
m
a
a
a
a
a
a
a
a
a
a
a
a
a
a
a
a
a
a
a
a
a
a
m
a
a
a
a
a
a
a
a
a
a
a
a
m
m
m
a
U
M
M
M
M
M
M
M
"}
(32,1,1) = {"
M
M
M
M
M
M
M
M
M
M
U
a
a
m
m
a
a
a
a
a
a
m
a
a
a
a
a
a
a
a
m
m
a
a
a
a
a
a
a
a
a
a
a
m
a
a
m
a
a
m
a
a
a
a
a
a
a
a
a
m
a
a
U
M
M
M
M
M
M
M
"}
(33,1,1) = {"
M
M
M
M
M
M
M
M
M
M
U
a
a
a
m
a
a
a
a
a
m
a
a
a
a
a
a
a
a
a
a
m
m
a
a
a
a
m
m
a
a
m
a
a
a
a
m
a
a
m
a
a
a
a
a
a
a
a
a
a
a
a
U
M
M
M
M
M
M
M
"}
(34,1,1) = {"
M
M
M
M
M
M
M
M
M
M
U
a
a
m
a
a
a
a
a
a
a
a
a
a
m
m
a
a
a
a
a
a
m
m
a
a
a
a
a
m
m
m
a
a
a
a
a
a
a
a
a
a
a
a
a
a
a
a
a
a
a
a
U
M
M
M
M
M
M
M
"}
(35,1,1) = {"
M
M
M
M
M
M
M
M
M
M
U
a
a
m
a
a
a
a
a
a
a
a
a
a
a
a
m
a
a
a
a
a
a
m
m
a
a
m
a
a
a
a
a
a
a
a
a
a
a
a
a
a
a
a
a
m
a
a
m
a
m
a
U
M
M
M
M
M
M
M
"}
(36,1,1) = {"
M
M
M
M
M
M
M
M
M
M
U
a
a
a
m
a
a
a
a
a
a
a
a
a
a
a
a
m
a
a
a
a
a
a
m
a
a
a
a
a
a
a
a
a
m
a
a
a
a
a
a
a
a
a
a
a
m
a
m
a
m
a
U
M
M
M
M
M
M
M
"}
(37,1,1) = {"
M
M
M
M
M
M
M
M
M
M
U
a
a
m
n
a
a
a
a
a
a
a
a
a
a
a
a
a
m
a
a
a
a
a
a
m
m
a
a
a
a
a
a
a
a
a
a
a
a
a
a
a
a
a
a
a
m
a
a
a
a
a
U
M
M
M
M
M
M
M
"}
(38,1,1) = {"
M
M
M
M
M
M
M
M
M
M
U
a
m
n
m
a
a
a
a
a
a
a
a
a
a
a
a
a
m
m
a
a
a
a
a
a
n
a
a
a
a
a
a
a
a
a
a
a
a
a
m
a
a
a
a
m
a
a
a
a
a
a
U
M
M
M
M
M
M
M
"}
(39,1,1) = {"
M
M
M
M
M
M
M
M
M
M
U
a
m
a
a
a
a
a
a
a
a
a
a
a
a
a
a
a
a
a
a
a
a
a
a
a
a
m
a
a
a
a
a
a
a
a
a
a
a
a
m
a
a
a
a
m
a
a
m
m
a
a
U
M
M
M
M
M
M
M
"}
(40,1,1) = {"
M
M
M
M
M
M
M
M
M
M
U
a
a
a
n
a
a
a
a
a
a
a
a
a
a
a
a
a
a
a
a
a
a
a
a
m
a
a
m
m
a
a
a
a
a
a
a
a
a
a
a
a
a
a
a
m
a
a
a
m
m
a
U
M
M
M
M
M
M
M
"}
(41,1,1) = {"
M
M
M
M
M
M
M
M
M
M
U
a
a
a
a
a
a
a
a
a
a
a
a
a
a
a
a
a
a
a
a
m
a
a
m
m
a
a
a
m
a
a
a
m
a
a
a
a
a
m
a
a
a
a
a
m
a
a
a
a
m
a
U
M
M
M
M
M
M
M
"}
(42,1,1) = {"
M
M
M
M
M
M
M
M
M
M
U
a
a
a
n
a
a
a
a
a
a
m
a
a
a
a
a
a
a
a
a
a
a
a
m
a
a
a
a
a
m
a
a
a
a
a
a
a
a
m
a
a
a
a
a
m
a
a
a
a
m
a
U
M
M
M
M
M
M
M
"}
(43,1,1) = {"
M
M
M
M
M
M
M
M
M
M
U
a
a
a
m
m
a
a
a
m
m
a
a
a
a
a
a
a
a
a
a
a
a
a
a
a
a
a
a
m
m
a
a
a
a
a
a
a
m
m
a
a
a
a
a
m
a
a
m
a
m
a
U
M
M
M
M
M
M
M
"}
(44,1,1) = {"
M
M
M
M
M
M
M
M
M
M
U
a
a
a
n
m
a
a
a
m
a
a
a
a
a
a
a
a
a
a
a
a
a
a
a
a
a
a
a
m
a
a
a
a
a
a
a
a
m
a
a
a
a
a
a
a
a
a
a
a
m
a
U
M
M
M
M
M
M
M
"}
(45,1,1) = {"
M
M
M
M
M
M
M
M
M
M
U
a
a
n
n
a
a
a
m
a
m
a
a
a
a
a
a
a
a
a
a
a
a
a
a
a
a
a
a
m
a
a
a
a
a
a
a
a
m
a
a
a
a
a
a
a
a
a
a
a
m
a
U
M
M
M
M
M
M
M
"}
(46,1,1) = {"
M
M
M
M
M
M
M
M
M
M
U
a
a
n
a
a
a
a
m
a
a
m
a
a
a
a
a
a
a
a
a
a
a
a
a
a
a
a
a
a
a
a
a
a
a
a
a
a
m
a
a
a
a
a
a
a
a
a
a
a
a
a
U
M
M
M
M
M
M
M
"}
(47,1,1) = {"
M
M
M
M
M
M
M
M
M
M
U
a
a
m
a
a
a
a
a
m
a
a
m
a
a
a
a
a
a
a
a
a
a
a
a
a
a
a
a
m
a
a
a
a
a
a
a
a
a
a
a
a
a
a
a
a
a
a
a
a
a
a
U
M
M
M
M
M
M
M
"}
(48,1,1) = {"
M
M
M
M
M
M
M
M
M
M
U
a
a
m
a
a
a
a
a
m
a
a
a
m
a
a
a
a
a
a
a
a
a
a
a
a
m
m
a
a
a
a
a
a
a
a
a
a
a
a
a
a
a
a
a
a
a
a
m
m
m
a
U
M
M
M
M
M
M
M
"}
(49,1,1) = {"
M
M
M
M
M
M
M
M
M
M
U
a
a
a
a
a
a
a
a
a
a
a
a
a
m
a
a
a
a
a
a
a
a
a
a
a
a
m
a
a
a
a
a
a
a
a
a
a
a
a
a
m
m
a
a
a
a
a
a
a
n
a
U
M
M
M
M
M
M
M
"}
(50,1,1) = {"
M
M
M
M
M
M
M
M
M
M
U
a
a
m
m
a
a
a
m
a
a
a
a
a
a
a
a
a
a
a
a
a
a
a
a
a
a
a
a
a
a
a
a
a
a
a
a
a
a
a
a
a
a
a
a
a
a
a
a
a
n
a
U
M
M
M
M
M
M
M
"}
(51,1,1) = {"
M
M
M
M
M
M
M
M
M
M
U
a
a
a
m
a
a
a
a
a
a
m
m
m
a
a
a
a
a
a
m
a
a
a
a
a
a
a
a
m
a
a
a
a
a
a
a
a
a
a
a
a
a
a
a
a
a
a
a
a
a
a
U
M
M
M
M
M
M
M
"}
(52,1,1) = {"
M
M
M
M
M
M
M
M
M
M
U
a
a
m
m
a
a
m
m
a
a
a
a
a
a
a
a
a
a
a
a
m
m
a
a
a
a
a
a
m
a
a
a
m
n
m
m
a
a
a
a
a
a
a
a
a
m
m
a
a
a
a
U
M
M
M
M
M
M
M
"}
(53,1,1) = {"
M
M
M
M
M
M
M
M
M
M
U
a
a
m
m
a
a
a
a
a
m
a
a
a
a
a
a
a
a
a
a
a
a
a
a
m
m
a
m
a
m
m
a
a
a
a
a
a
a
a
a
a
a
a
a
m
a
a
n
m
m
a
U
M
M
M
M
M
M
M
"}
(54,1,1) = {"
M
M
M
M
M
M
M
M
M
M
U
a
m
a
a
a
a
a
a
a
a
a
m
a
a
a
m
m
a
a
a
a
a
m
a
m
m
a
a
a
a
a
a
a
a
a
a
a
a
a
a
a
a
a
a
a
a
m
a
a
m
a
U
M
M
M
M
M
M
M
"}
(55,1,1) = {"
M
M
M
M
M
M
M
M
M
M
U
a
m
a
m
a
a
a
a
a
a
a
a
m
m
a
a
m
a
a
a
a
a
a
a
a
a
a
a
m
a
a
a
a
a
a
a
a
a
a
a
a
a
a
a
a
m
m
a
a
a
a
U
M
M
M
M
M
M
M
"}
(56,1,1) = {"
M
M
M
M
M
M
M
M
M
M
U
a
a
m
a
a
a
a
a
a
a
a
a
a
a
a
m
m
a
a
a
a
a
a
a
a
a
a
a
m
a
a
a
a
a
a
a
a
a
m
m
a
a
a
a
a
m
a
m
n
m
a
U
M
M
M
M
M
M
M
"}
(57,1,1) = {"
M
M
M
M
M
M
M
M
M
M
U
a
a
m
a
a
a
a
a
a
a
a
a
a
a
a
a
a
a
a
a
a
a
a
a
a
a
a
a
a
a
a
a
a
m
m
a
a
a
a
a
a
a
a
a
a
a
a
a
m
m
a
U
M
M
M
M
M
M
M
"}
(58,1,1) = {"
M
M
M
M
M
M
M
M
M
M
U
a
a
a
a
m
m
m
a
a
a
a
m
a
a
a
a
a
a
a
a
a
a
a
a
a
a
a
a
a
a
a
a
a
a
n
a
m
m
m
a
a
a
a
a
m
a
a
a
m
a
a
U
M
M
M
M
M
M
M
"}
(59,1,1) = {"
M
M
M
M
M
M
M
M
M
M
U
a
m
a
m
a
a
a
m
m
m
a
a
a
a
a
a
a
a
a
a
a
a
a
m
a
m
m
m
n
a
a
a
a
a
m
m
a
a
a
a
a
a
a
a
a
a
a
a
m
a
a
U
M
M
M
M
M
M
M
"}
(60,1,1) = {"
M
M
M
M
M
M
M
M
M
M
U
a
m
a
m
a
a
a
a
a
a
a
a
a
a
a
a
a
a
a
a
a
a
a
a
a
a
a
a
a
a
a
a
a
a
a
a
a
a
a
a
a
a
a
a
a
a
a
a
a
a
a
U
M
M
M
M
M
M
M
"}
(61,1,1) = {"
M
M
M
M
M
M
M
M
M
M
U
a
a
a
m
a
a
a
a
a
a
a
a
a
a
a
a
a
a
a
a
a
a
a
a
a
a
a
a
a
a
a
a
a
a
a
a
a
a
a
a
a
a
a
a
a
a
a
a
m
m
a
U
M
M
M
M
M
M
M
"}
(62,1,1) = {"
M
M
M
M
M
M
M
M
M
M
U
a
a
m
a
a
a
a
a
a
a
a
a
a
a
a
a
a
a
a
a
a
a
a
a
a
a
a
a
a
a
a
a
a
a
a
a
a
a
a
a
a
a
a
a
a
a
a
a
m
m
a
U
M
M
M
M
M
M
M
"}
(63,1,1) = {"
M
M
M
M
M
M
M
M
M
M
U
a
a
m
a
a
a
a
a
a
a
a
a
a
a
a
a
a
a
a
a
a
a
a
a
a
a
a
a
a
a
a
a
a
a
a
a
a
a
a
a
a
a
a
a
a
a
a
a
a
a
a
U
M
M
M
M
M
M
M
"}
(64,1,1) = {"
M
M
M
M
M
M
M
M
M
M
U
a
a
a
m
a
a
a
a
a
a
a
m
a
a
a
a
a
a
a
a
a
a
a
a
a
a
a
a
a
a
a
a
a
a
a
a
a
a
a
a
a
a
a
a
a
m
a
a
a
a
a
U
M
M
M
M
M
M
M
"}
(65,1,1) = {"
M
M
M
M
M
M
M
M
M
M
U
a
a
a
m
a
a
a
a
a
m
m
a
a
a
a
a
a
a
a
a
a
a
a
a
a
a
a
a
a
a
a
a
a
a
a
a
a
a
a
a
a
a
a
a
a
m
a
a
a
a
a
U
M
M
M
M
M
M
M
"}
(66,1,1) = {"
M
M
M
M
M
M
M
M
M
M
U
a
a
m
m
a
a
a
a
a
a
a
a
a
a
a
a
a
a
a
a
a
a
a
a
a
a
a
a
a
a
a
a
a
a
a
a
a
a
a
a
a
a
a
a
a
a
a
m
a
a
a
U
M
M
M
M
M
M
M
"}
(67,1,1) = {"
M
M
M
M
M
M
M
M
M
M
U
a
a
m
a
a
a
a
a
a
a
a
a
a
a
a
a
a
a
a
a
a
a
a
a
a
a
a
a
a
a
a
a
a
a
a
a
a
a
a
a
a
a
a
a
m
a
a
a
m
a
a
U
M
M
M
M
M
M
M
"}
(68,1,1) = {"
M
M
M
M
M
M
M
M
M
M
U
a
m
m
a
a
a
a
a
a
a
a
a
a
a
a
a
a
a
a
a
a
a
a
a
a
a
a
a
a
a
a
a
a
a
a
a
a
a
a
a
a
a
m
n
m
a
a
a
a
m
a
U
M
M
M
M
M
M
M
"}
(69,1,1) = {"
M
M
M
M
M
M
M
M
M
M
U
a
n
a
a
a
a
a
a
a
a
a
a
a
a
a
a
a
a
a
a
a
a
a
a
a
a
a
a
a
a
a
a
a
a
a
a
m
a
a
n
m
m
n
a
a
a
a
a
a
m
a
U
M
M
M
M
M
M
M
"}
(70,1,1) = {"
M
M
M
M
M
M
M
M
M
M
U
a
m
a
a
a
a
a
a
a
a
a
a
a
a
a
a
a
a
a
a
a
a
a
a
a
a
a
a
a
a
a
a
a
a
a
a
a
a
a
a
n
m
a
a
a
a
a
a
n
m
a
U
M
M
M
M
M
M
M
"}
(71,1,1) = {"
M
M
M
M
M
M
M
M
M
M
U
a
m
a
a
a
a
a
a
a
a
a
a
a
a
a
a
a
a
a
a
a
a
a
a
a
a
a
a
a
a
a
a
a
a
a
a
a
a
a
a
m
a
a
a
a
a
a
m
a
a
a
U
M
M
M
M
M
M
M
"}
(72,1,1) = {"
M
M
M
M
M
M
M
M
M
M
U
a
m
a
a
a
a
a
a
a
a
a
a
a
a
a
a
a
a
a
a
a
a
a
a
a
a
a
a
a
a
a
a
a
a
a
a
a
a
a
a
m
a
a
a
a
a
m
a
m
m
m
U
M
M
M
M
M
M
M
"}
(73,1,1) = {"
M
M
M
M
M
M
M
M
M
M
U
a
m
a
a
m
a
a
a
a
a
a
a
m
m
a
a
m
m
a
m
a
m
a
a
a
a
a
a
a
a
a
a
a
a
a
a
a
a
a
m
a
a
a
a
a
a
a
a
a
a
a
U
M
M
M
M
M
M
M
"}
(74,1,1) = {"
M
M
M
M
M
M
M
M
M
M
U
a
a
a
a
m
a
a
a
a
a
a
a
a
a
a
a
a
a
a
a
a
a
a
a
a
a
a
a
a
a
a
a
a
a
a
a
a
a
m
a
a
a
a
a
a
a
a
a
m
a
a
U
M
M
M
M
M
M
M
"}
(75,1,1) = {"
M
M
M
M
M
M
M
M
M
M
U
a
a
a
a
m
a
a
a
a
a
a
a
a
a
a
a
a
a
a
a
a
a
a
a
a
a
a
a
a
a
a
a
a
a
a
a
m
m
a
a
a
a
a
a
a
a
a
a
a
m
a
U
M
M
M
M
M
M
M
"}
(76,1,1) = {"
M
M
M
M
M
M
M
M
M
M
U
a
a
a
m
a
a
a
a
a
a
a
a
a
a
a
a
a
a
a
a
a
a
a
a
a
a
a
m
a
m
m
a
m
a
a
a
a
a
a
a
a
a
a
a
a
a
a
a
a
m
a
U
M
M
M
M
M
M
M
"}
(77,1,1) = {"
M
M
M
M
M
M
M
M
M
M
U
a
a
a
a
a
a
a
a
a
a
a
a
a
a
a
a
a
a
a
a
a
a
a
a
m
m
m
a
a
a
a
a
a
a
a
a
a
a
a
a
a
a
a
a
a
a
a
a
a
a
m
U
M
M
M
M
M
M
M
"}
(78,1,1) = {"
M
M
M
M
M
M
M
M
M
M
U
a
a
a
m
m
a
a
a
a
a
a
a
a
a
a
a
a
a
a
a
a
a
a
a
a
a
a
a
a
a
a
a
a
a
a
m
a
a
m
a
a
a
a
a
a
a
a
a
a
m
a
U
M
M
M
M
M
M
M
"}
(79,1,1) = {"
M
M
M
M
M
M
M
M
M
M
U
a
a
m
m
n
m
m
a
a
m
m
a
a
a
a
a
a
m
a
a
a
a
a
a
a
a
a
a
n
a
a
a
a
m
m
m
a
a
a
m
a
m
a
m
m
m
a
a
m
a
a
U
M
M
M
M
M
M
M
"}
(80,1,1) = {"
M
M
M
M
M
M
M
M
M
M
U
a
a
a
m
m
m
a
a
a
m
n
a
a
a
a
m
a
m
m
a
a
m
a
a
a
a
a
a
a
a
a
n
a
a
a
m
a
a
a
m
a
m
a
m
m
n
m
n
a
a
a
U
M
M
M
M
M
M
M
"}
(81,1,1) = {"
M
M
M
M
M
M
M
M
M
M
U
a
a
a
a
a
a
a
a
a
a
a
a
m
a
a
a
a
a
a
a
a
m
m
a
a
a
a
m
m
n
a
a
a
a
m
m
a
a
a
a
m
m
m
a
m
a
m
m
a
a
a
U
M
M
M
M
M
M
M
"}
(82,1,1) = {"
M
M
M
M
M
M
M
M
M
M
U
a
a
a
a
a
a
a
a
a
a
a
a
a
m
a
a
a
a
a
a
a
a
a
a
a
a
m
a
a
a
a
a
a
a
a
a
a
a
a
m
a
a
a
a
a
a
a
a
a
a
a
U
M
M
M
M
M
M
M
"}
(83,1,1) = {"
M
M
M
M
M
M
M
M
M
M
U
U
U
U
U
U
U
U
U
U
U
U
U
U
W
U
U
U
U
U
U
U
U
U
U
U
U
U
U
U
U
U
U
U
U
U
U
U
U
U
U
U
U
U
U
U
U
U
U
U
U
U
U
M
M
M
M
M
M
M
"}
(84,1,1) = {"
M
M
M
M
M
M
M
M
M
M
M
M
M
M
M
M
M
M
M
M
M
M
M
M
M
M
M
M
M
M
M
M
M
M
M
M
M
M
M
M
M
M
M
M
M
M
M
M
M
M
M
M
M
M
M
M
M
M
M
M
M
M
M
M
M
M
M
M
M
M
"}
(85,1,1) = {"
M
M
M
M
M
M
M
M
M
M
M
M
M
M
M
M
M
M
M
M
M
M
M
M
M
M
M
M
M
M
M
M
M
M
M
M
M
M
M
M
M
M
M
M
M
M
M
M
M
M
M
M
M
M
M
M
M
M
M
M
M
M
M
M
M
M
M
M
M
M
"}
(86,1,1) = {"
M
M
M
M
M
M
M
M
M
M
M
M
M
M
M
M
M
M
M
M
M
M
M
M
M
M
M
M
M
M
M
M
M
M
M
M
M
M
M
M
M
M
M
M
M
M
M
M
M
M
M
M
M
M
M
M
M
M
M
M
M
M
M
M
M
M
M
M
M
M
"}
(87,1,1) = {"
M
M
M
M
M
M
M
M
M
M
M
M
M
M
M
M
M
M
M
M
M
M
M
M
M
M
M
M
M
M
M
M
M
M
M
M
M
M
M
M
M
M
M
M
M
M
M
M
M
M
M
M
M
M
M
M
M
M
M
M
M
M
M
M
M
M
M
M
M
M
"}
(88,1,1) = {"
M
M
M
M
M
M
M
M
M
M
M
M
M
M
M
M
M
M
M
M
M
M
M
M
M
M
M
M
M
M
M
M
M
M
M
M
M
M
M
M
M
M
M
M
M
M
M
M
M
M
M
M
M
M
M
M
M
M
M
M
M
M
M
M
M
M
M
M
M
M
"}
(89,1,1) = {"
M
M
M
M
M
M
M
M
M
M
M
M
M
M
M
M
M
M
M
M
M
M
M
M
M
M
M
M
M
M
M
M
M
M
M
M
M
M
M
M
M
M
M
M
M
M
M
M
M
M
M
M
M
M
M
M
M
M
M
M
M
M
M
M
M
M
M
M
M
M
"}
(90,1,1) = {"
M
M
M
M
M
M
M
M
M
M
M
M
M
M
M
M
M
M
M
M
M
M
M
M
M
M
M
M
M
M
M
M
M
M
M
M
M
M
M
M
M
M
M
M
M
M
M
M
M
M
M
M
M
M
M
M
M
M
M
M
M
M
M
M
M
M
M
M
M
M
"}
