//MAP CONVERTED BY dmm2tgm.py THIS HEADER COMMENT PREVENTS RECONVERSION, DO NOT REMOVE
"a" = (
/turf/open/space/basic,
/area/template_noop)
"b" = (
/obj/machinery/conveyor/auto{
	dir = 8
	},
/obj/effect/dummy/lighting_obj{
	light_range = 10
	},
/turf/open/floor/glass/cyan,
/area/hangar)
"c" = (
/obj/effect/landmark/outpost/elevator,
/turf/open/floor/plasteel/elevatorshaft{
	planetary_atmos = 1
	},
/area/hangar)
"e" = (
/turf/closed/indestructible/reinforced,
/area/hangar)
"f" = (
/obj/structure/plasticflaps/outpost,
/obj/machinery/conveyor/auto/outpost,
/obj/effect/dummy/lighting_obj{
	light_range = 10
	},
/turf/open/floor/glass/cyan,
/area/hangar)
"h" = (
/turf/open/floor/plasteel/elevatorshaft{
	planetary_atmos = 1
	},
/area/hangar)
"n" = (
/obj/structure/railing,
/obj/effect/dummy/lighting_obj{
	light_range = 10
	},
/turf/open/floor/glass/cyan,
/area/hangar)
"o" = (
/obj/machinery/conveyor/auto{
	dir = 10
	},
/obj/effect/dummy/lighting_obj{
	light_range = 10
	},
/turf/open/floor/glass/cyan,
/area/hangar)
"u" = (
/obj/machinery/conveyor/auto{
	dir = 4;
	id = "outpost3"
	},
/obj/machinery/recycler,
/obj/effect/dummy/lighting_obj{
	light_range = 10
	},
/turf/open/floor/glass/cyan,
/area/hangar)
"v" = (
/obj/effect/dummy/lighting_obj{
	light_range = 10
	},
/obj/effect/dummy/lighting_obj{
	light_range = 10
	},
/turf/open/floor/glass/cyan,
/area/hangar)
"w" = (
/obj/structure/window/reinforced/fulltile/indestructible{
	alpha = 0
	},
/turf/open/space/basic,
/area/hangar)
"x" = (
/obj/structure/window/reinforced/fulltile/indestructible{
	alpha = 0
	},
/turf/open/space/anima,
/area/hangar)
"y" = (
/turf/open/floor/glass/cyan,
/area/hangar)
"A" = (
/obj/effect/dummy/lighting_obj{
	light_range = 10
	},
/turf/open/floor/glass/cyan,
/area/hangar)
"B" = (
/obj/structure/railing{
	dir = 4
	},
/obj/effect/dummy/lighting_obj{
	light_range = 10
	},
/turf/open/floor/glass/cyan,
/area/hangar)
"F" = (
/obj/effect/landmark/portal_exit{
	id = "cargo_20x20"
	},
/obj/machinery/conveyor/auto/outpost,
/obj/effect/dummy/lighting_obj{
	light_range = 10
	},
/turf/open/floor/glass/cyan,
/area/hangar)
"G" = (
/obj/machinery/conveyor/auto{
	id = "outpost3";
	use_static_power = 1;
	dir = 9
	},
/obj/effect/dummy/lighting_obj{
	light_range = 10
	},
/turf/open/floor/glass/cyan,
/area/hangar)
"H" = (
/obj/effect/landmark/outpost/shaft_number,
/turf/open/floor/glass/cyan,
/area/hangar)
"I" = (
/obj/machinery/conveyor/auto/outpost{
	dir = 8
	},
/obj/effect/dummy/lighting_obj{
	light_range = 10
	},
/turf/open/floor/glass/cyan,
/area/hangar)
"J" = (
/obj/effect/landmark/outpost/hangar_numbers,
/turf/open/floor/glass/cyan,
/area/hangar)
"K" = (
/obj/machinery/door/airlock,
/obj/effect/landmark/outpost/elevator_machine,
/turf/open/floor/glass/cyan,
/area/hangar)
"L" = (
/obj/structure/railing{
	dir = 8
	},
/obj/effect/dummy/lighting_obj{
	light_range = 10
	},
/turf/open/floor/glass/cyan,
/area/hangar)
"M" = (
/obj/effect/landmark/outpost/hangar_dock,
/obj/effect/dummy/lighting_obj{
	light_range = 10
	},
/turf/open/floor/glass/cyan,
/area/hangar)
"O" = (
/obj/effect/portal/permanent/one_way{
	id = "cargo_20x20"
	},
/obj/effect/dummy/lighting_obj{
	light_range = 10
	},
/turf/open/floor/glass/cyan,
/area/hangar)
"P" = (
/obj/machinery/conveyor/auto{
	dir = 6;
	id = "outpost3"
	},
/obj/effect/dummy/lighting_obj{
	light_range = 10
	},
/turf/open/floor/glass/cyan,
/area/hangar)
"Q" = (
/obj/machinery/conveyor/auto/outpost{
	dir = 1
	},
/obj/effect/dummy/lighting_obj{
	light_range = 10
	},
/turf/open/floor/glass/cyan,
/area/hangar)
"T" = (
/obj/effect/dummy/lighting_obj{
	light_range = 10
	},
/obj/effect/dummy/lighting_obj{
	light_range = 10
	},
/obj/effect/dummy/lighting_obj{
	light_range = 10
	},
/turf/open/floor/glass/cyan,
/area/hangar)
"U" = (
/obj/effect/dummy/lighting_obj{
	light_range = 10
	},
/obj/effect/dummy/lighting_obj{
	light_range = 10
	},
/obj/structure/railing,
/turf/open/floor/glass/cyan,
/area/hangar)
"V" = (
/obj/effect/landmark/outpost/hangar_crate_spawner,
/obj/machinery/conveyor/auto/outpost{
	dir = 8
	},
/turf/open/floor/glass/cyan,
/area/hangar)
"W" = (
/obj/machinery/conveyor/auto/outpost,
/obj/effect/dummy/lighting_obj{
	light_range = 10
	},
/turf/open/floor/glass/cyan,
/area/hangar)
"X" = (
/obj/machinery/conveyor/auto/outpost{
	dir = 4
	},
/obj/effect/dummy/lighting_obj{
	light_range = 10
	},
/turf/open/floor/glass/cyan,
/area/hangar)
"Y" = (
/obj/machinery/conveyor/auto{
	dir = 5;
	id = "outpost3"
	},
/obj/effect/dummy/lighting_obj{
	light_range = 10
	},
/turf/open/floor/glass/cyan,
/area/hangar)
"Z" = (
/obj/effect/landmark/outpost/elevator_machine,
/obj/machinery/elevator_call_button{
	pixel_y = 31;
	pixel_x = 10
	},
/turf/open/floor/glass/cyan,
/area/hangar)

(1,1,1) = {"
w
w
w
a
a
a
a
a
a
a
a
a
a
a
a
a
a
a
a
a
a
a
a
a
a
a
a
a
a
a
a
a
a
a
a
a
a
a
a
a
a
a
a
a
a
a
a
a
a
a
a
a
"}
(2,1,1) = {"
w
O
w
a
a
a
a
a
a
a
a
a
a
a
a
a
a
a
a
a
a
a
a
a
a
a
a
a
a
a
a
a
a
a
a
a
a
a
a
a
a
a
a
a
a
a
a
a
a
a
a
a
"}
(3,1,1) = {"
w
V
w
a
a
a
a
a
a
a
a
a
a
a
a
a
a
a
a
a
a
a
a
a
a
a
a
a
a
a
a
a
a
a
a
a
a
a
a
a
a
a
a
a
a
a
a
a
a
a
a
a
"}
(4,1,1) = {"
w
w
w
a
a
a
a
a
a
a
a
a
a
a
a
a
a
a
a
a
a
a
a
a
a
a
a
a
a
a
a
a
a
a
a
a
a
a
a
a
a
a
a
a
a
a
a
a
a
a
a
a
"}
(5,1,1) = {"
a
a
a
a
a
a
a
a
a
a
a
a
a
a
a
a
a
a
a
a
a
a
a
a
a
a
a
a
a
a
a
a
a
a
a
a
a
a
a
a
a
a
a
a
a
a
a
a
a
a
a
a
"}
(6,1,1) = {"
a
a
a
a
a
a
a
a
a
a
a
a
a
a
a
a
a
a
a
a
a
a
a
a
a
a
a
a
a
a
a
a
a
a
a
a
a
a
a
a
a
a
a
a
a
a
a
a
a
a
a
a
"}
(7,1,1) = {"
a
a
a
a
a
a
a
a
a
a
a
a
a
a
a
a
a
a
a
a
a
a
a
a
a
a
a
a
a
a
a
a
a
a
a
a
a
a
a
a
a
a
a
a
a
a
a
a
a
a
a
a
"}
(8,1,1) = {"
a
a
a
a
a
a
a
a
a
a
a
a
a
a
a
a
a
a
a
a
a
a
a
a
a
a
a
a
a
a
a
a
a
a
a
a
a
a
a
a
a
a
a
a
a
a
a
a
a
a
a
a
"}
(9,1,1) = {"
a
a
a
a
a
a
a
a
a
a
a
a
a
a
a
a
a
a
w
w
w
w
w
w
w
w
w
w
w
w
w
w
w
w
w
w
w
w
w
w
w
w
w
w
w
a
a
a
a
a
a
a
"}
(10,1,1) = {"
a
a
a
a
a
a
a
a
a
a
a
a
a
a
a
a
a
a
w
A
A
A
A
A
A
A
A
A
A
A
A
A
A
A
A
A
A
A
A
A
A
A
A
A
w
a
a
a
a
a
a
a
"}
(11,1,1) = {"
a
a
a
a
a
a
a
a
a
a
a
a
w
w
w
w
w
w
w
A
A
A
A
A
A
A
A
A
A
A
A
A
A
A
A
A
A
A
A
A
A
A
A
A
w
a
a
a
a
a
a
a
"}
(12,1,1) = {"
a
a
a
a
a
a
a
a
a
a
a
a
x
A
A
A
A
A
A
A
A
v
A
A
A
v
A
A
A
v
A
A
A
v
A
A
A
T
A
A
A
v
A
A
w
a
a
a
a
a
a
a
"}
(13,1,1) = {"
a
a
a
a
a
a
a
a
a
a
a
a
x
A
W
W
X
A
A
A
A
A
A
A
A
A
A
A
A
A
A
A
A
A
A
A
A
A
v
A
A
A
A
A
w
a
a
a
a
a
a
a
"}
(14,1,1) = {"
a
a
a
a
a
a
a
a
a
w
w
w
x
A
I
A
X
A
A
A
A
A
A
A
A
A
A
A
A
A
A
A
A
A
A
A
A
A
v
M
A
A
A
A
w
a
a
a
a
a
a
a
"}
(15,1,1) = {"
a
a
a
a
a
a
a
a
a
w
F
W
f
W
I
A
X
A
A
A
A
A
A
A
A
A
v
A
v
v
A
v
A
A
A
A
A
A
A
A
A
A
A
A
w
a
a
a
a
a
a
a
"}
(16,1,1) = {"
a
a
a
a
a
a
a
a
a
w
w
w
w
A
I
A
X
A
A
A
A
v
A
A
A
A
A
A
A
A
A
A
v
A
A
A
A
A
A
v
v
v
A
A
w
a
a
a
a
a
a
a
"}
(17,1,1) = {"
a
a
a
a
a
a
a
a
a
a
a
a
w
A
I
Q
Q
A
A
A
A
A
A
v
A
A
A
A
A
A
A
A
A
A
A
A
A
v
A
A
v
A
A
A
w
a
a
a
a
a
a
a
"}
(18,1,1) = {"
a
a
a
a
a
a
a
a
a
a
a
a
w
A
A
A
A
A
A
A
A
A
A
v
v
A
A
A
A
A
A
A
A
A
A
A
A
A
A
A
A
A
A
A
w
a
a
a
a
a
a
a
"}
(19,1,1) = {"
a
a
a
a
a
a
a
a
a
a
a
a
w
w
w
w
w
w
w
A
A
A
A
A
v
A
A
A
A
A
A
A
A
A
A
A
A
A
A
A
v
A
A
A
w
a
a
a
a
a
a
a
"}
(20,1,1) = {"
a
a
a
a
a
a
a
a
a
a
a
a
a
a
a
a
a
w
w
A
A
v
A
A
A
v
A
A
A
A
A
A
A
A
A
A
A
A
A
A
v
T
A
A
w
a
a
a
a
a
a
a
"}
(21,1,1) = {"
a
a
a
a
a
a
a
a
a
a
a
a
e
e
e
e
e
Z
y
A
A
A
A
A
A
A
A
A
A
A
A
A
A
A
A
A
A
A
A
A
A
v
A
A
w
a
a
a
a
a
a
a
"}
(22,1,1) = {"
a
a
a
a
a
a
a
a
a
a
a
a
e
h
h
c
K
A
y
A
A
A
A
A
A
A
v
A
A
A
A
A
A
A
A
A
A
A
A
A
A
v
A
A
w
a
a
a
a
a
a
a
"}
(23,1,1) = {"
a
a
a
a
a
a
a
a
a
a
a
a
e
h
h
h
K
y
H
A
A
v
A
A
A
A
A
A
A
A
A
A
A
A
A
A
A
A
A
A
A
v
v
A
w
a
a
a
a
a
a
a
"}
(24,1,1) = {"
a
a
a
a
a
a
a
a
a
a
a
a
e
h
h
h
K
A
J
A
A
T
A
A
A
A
A
A
A
A
v
v
v
v
A
A
A
A
A
A
v
T
A
A
w
a
a
a
a
a
a
a
"}
(25,1,1) = {"
a
a
a
a
a
a
a
a
a
a
a
a
e
e
e
e
e
y
y
A
A
v
A
A
A
A
T
v
T
A
A
A
A
A
v
A
A
A
A
v
v
v
A
A
w
a
a
a
a
a
a
a
"}
(26,1,1) = {"
a
a
a
a
a
a
a
a
a
a
a
a
a
a
a
a
a
w
w
A
A
v
A
A
A
A
A
A
A
A
A
A
A
A
A
v
A
A
A
v
v
A
A
A
w
a
a
a
a
a
a
a
"}
(27,1,1) = {"
a
a
a
a
a
a
a
a
a
a
a
a
a
a
a
a
a
a
w
A
A
A
A
A
A
A
A
A
v
v
A
A
A
A
A
A
A
A
A
A
A
A
A
A
w
a
a
a
a
a
a
a
"}
(28,1,1) = {"
a
a
a
a
a
a
a
a
a
a
a
a
a
a
a
a
a
a
w
A
A
v
A
A
A
A
v
A
A
v
A
A
A
A
A
A
A
A
A
A
A
T
v
A
w
a
a
a
a
a
a
a
"}
(29,1,1) = {"
a
a
a
a
a
a
a
a
a
a
a
a
a
a
a
a
a
a
w
A
A
A
A
A
A
A
A
A
A
v
v
A
A
A
A
A
A
A
A
v
A
A
v
v
w
a
a
a
a
a
a
a
"}
(30,1,1) = {"
a
a
a
a
a
a
a
a
a
a
a
a
a
a
a
a
a
a
w
A
A
A
A
A
A
A
A
A
A
A
v
v
v
v
A
v
A
A
A
A
A
A
A
v
w
a
a
a
a
a
a
a
"}
(31,1,1) = {"
a
a
a
a
a
a
a
a
a
a
a
a
a
w
w
w
w
w
w
A
A
A
A
A
A
A
A
A
A
A
v
v
A
A
A
A
A
A
v
A
A
A
A
A
w
a
a
a
a
a
a
a
"}
(32,1,1) = {"
a
a
a
a
a
a
a
a
a
a
a
a
a
w
A
B
B
A
A
A
A
v
A
A
A
A
A
A
v
v
A
A
A
A
A
A
A
v
v
A
A
A
A
v
w
a
a
a
a
a
a
a
"}
(33,1,1) = {"
a
a
a
a
a
a
a
a
a
a
a
a
a
w
n
Y
G
A
A
A
A
v
A
A
A
A
A
A
v
v
v
v
v
A
A
A
A
v
v
A
A
v
v
v
w
a
a
a
a
a
a
a
"}
(34,1,1) = {"
a
a
a
a
a
a
a
a
a
a
a
a
a
w
n
u
b
A
A
A
A
v
A
A
A
v
A
A
A
A
A
A
A
A
A
A
A
A
v
A
A
v
v
v
w
a
a
a
a
a
a
a
"}
(35,1,1) = {"
a
a
a
a
a
a
a
a
a
a
a
a
a
w
U
P
o
A
A
A
A
A
A
A
A
A
v
A
A
A
A
A
A
A
A
A
A
A
A
A
A
A
v
v
w
a
a
a
a
a
a
a
"}
(36,1,1) = {"
a
a
a
a
a
a
a
a
a
a
a
a
a
w
A
L
L
A
A
A
A
A
A
A
A
A
v
A
A
A
A
A
A
A
A
A
A
A
A
A
A
v
A
A
w
a
a
a
a
a
a
a
"}
(37,1,1) = {"
a
a
a
a
a
a
a
a
a
a
a
a
a
w
w
w
w
w
w
A
A
A
A
A
A
A
A
A
A
A
A
A
A
A
A
A
A
A
A
A
A
T
v
A
w
a
a
a
a
a
a
a
"}
(38,1,1) = {"
a
a
a
a
a
a
a
a
a
a
a
a
a
a
a
a
a
a
w
A
A
v
A
A
A
A
A
A
A
A
A
A
A
A
A
A
A
A
A
A
A
v
A
A
w
a
a
a
a
a
a
a
"}
(39,1,1) = {"
a
a
a
a
a
a
a
a
a
a
a
a
a
a
a
a
a
a
w
A
A
v
A
A
A
A
v
A
A
A
A
A
A
A
A
A
A
A
A
A
A
v
A
A
w
a
a
a
a
a
a
a
"}
(40,1,1) = {"
a
a
a
a
a
a
a
a
a
a
a
a
a
a
a
a
a
a
w
A
A
v
A
A
A
A
A
A
A
A
A
A
A
A
A
v
v
A
A
A
A
A
v
v
w
a
a
a
a
a
a
a
"}
(41,1,1) = {"
a
a
a
a
a
a
a
a
a
a
a
a
a
a
a
a
a
a
w
A
A
v
A
A
A
A
A
A
A
A
A
A
A
A
A
A
v
A
A
A
A
A
A
T
w
a
a
a
a
a
a
a
"}
(42,1,1) = {"
a
a
a
a
a
a
a
a
a
a
a
a
a
a
a
a
a
a
w
A
A
v
A
A
A
A
A
A
A
A
A
A
A
v
A
A
A
A
A
A
A
A
A
v
w
a
a
a
a
a
a
a
"}
(43,1,1) = {"
a
a
a
a
a
a
a
a
a
a
a
a
a
a
a
a
a
a
w
A
A
A
A
A
A
v
A
A
A
A
A
A
A
v
v
A
A
A
A
A
A
A
v
v
w
a
a
a
a
a
a
a
"}
(44,1,1) = {"
a
a
a
a
a
a
a
a
a
a
a
a
a
a
a
a
a
a
w
A
A
A
A
A
A
A
A
A
A
A
A
A
A
A
A
A
A
A
A
A
A
A
v
v
w
a
a
a
a
a
a
a
"}
(45,1,1) = {"
a
a
a
a
a
a
a
a
a
a
a
a
a
a
a
a
a
a
w
A
A
v
A
A
A
A
A
A
A
A
A
A
A
A
v
A
A
A
A
A
A
v
A
A
w
a
a
a
a
a
a
a
"}
(46,1,1) = {"
a
a
a
a
a
a
a
a
a
a
a
a
a
a
a
a
a
a
w
A
A
v
A
A
A
A
A
A
A
A
A
A
A
A
A
A
A
A
A
A
A
v
A
A
w
a
a
a
a
a
a
a
"}
(47,1,1) = {"
a
a
a
a
a
a
a
a
a
a
a
a
a
a
a
a
a
a
w
A
A
v
A
A
A
A
A
v
A
v
A
A
A
A
v
A
A
A
A
A
v
A
A
v
w
a
a
a
a
a
a
a
"}
(48,1,1) = {"
a
a
a
a
a
a
a
a
a
a
a
a
a
a
a
a
a
a
w
A
v
A
A
A
A
A
A
v
A
A
A
A
A
A
A
A
A
A
A
A
A
A
A
v
w
a
a
a
a
a
a
a
"}
(49,1,1) = {"
a
a
a
a
a
a
a
a
a
a
a
a
a
a
a
a
a
a
w
A
A
A
A
A
A
A
A
A
A
A
A
A
A
A
A
v
A
A
A
A
v
v
A
v
w
a
a
a
a
a
a
a
"}
(50,1,1) = {"
a
a
a
a
a
a
a
a
a
a
a
a
a
a
a
a
a
a
w
A
A
A
A
A
A
A
A
A
v
A
v
A
A
A
A
A
A
A
A
v
A
A
A
v
w
a
a
a
a
a
a
a
"}
(51,1,1) = {"
a
a
a
a
a
a
a
a
a
a
a
a
a
a
a
a
a
a
w
A
v
A
A
A
A
A
A
A
A
v
A
v
A
A
A
A
A
A
A
A
A
A
A
v
w
a
a
a
a
a
a
a
"}
(52,1,1) = {"
a
a
a
a
a
a
a
a
a
a
a
a
a
a
a
a
a
a
w
A
v
A
A
A
A
A
A
A
A
v
v
v
A
A
A
v
v
v
A
A
A
v
A
A
w
a
a
a
a
a
a
a
"}
(53,1,1) = {"
a
a
a
a
a
a
a
a
a
a
a
a
a
a
a
a
a
a
w
A
v
A
A
A
A
A
A
A
A
A
A
A
A
A
v
A
A
A
A
A
A
v
A
A
w
a
a
a
a
a
a
a
"}
(54,1,1) = {"
a
a
a
a
a
a
a
a
a
a
a
a
a
a
a
a
a
a
w
A
v
A
A
A
A
A
A
A
A
A
A
A
A
v
A
A
A
A
A
A
T
v
A
v
w
a
a
a
a
a
a
a
"}
(55,1,1) = {"
a
a
a
a
a
a
a
a
a
a
a
a
a
a
a
a
a
a
w
A
A
A
A
A
A
A
A
A
A
A
A
A
v
A
A
A
A
A
A
A
A
v
v
v
w
a
a
a
a
a
a
a
"}
(56,1,1) = {"
a
a
a
a
a
a
a
a
a
a
a
a
a
a
a
a
a
a
w
A
A
A
A
A
A
A
A
A
A
A
A
v
v
A
A
A
A
A
A
A
T
v
A
A
w
a
a
a
a
a
a
a
"}
(57,1,1) = {"
a
a
a
a
a
a
a
a
a
a
a
a
a
a
a
a
a
a
w
A
v
A
A
A
A
A
A
A
v
v
v
A
v
v
A
A
A
A
A
A
v
A
v
A
w
a
a
a
a
a
a
a
"}
(58,1,1) = {"
a
a
a
a
a
a
a
a
a
a
a
a
a
a
a
a
a
a
w
A
v
A
A
A
A
A
A
A
A
A
A
A
A
A
v
A
A
A
A
v
A
A
v
A
w
a
a
a
a
a
a
a
"}
(59,1,1) = {"
a
a
a
a
a
a
a
a
a
a
a
a
a
a
a
a
a
a
w
A
v
A
A
A
A
A
A
A
v
A
A
A
A
A
v
v
A
A
A
v
A
A
v
A
w
a
a
a
a
a
a
a
"}
(60,1,1) = {"
a
a
a
a
a
a
a
a
a
a
a
a
a
a
a
a
a
a
w
A
v
A
A
A
v
v
A
A
A
v
A
A
A
A
A
A
A
A
v
v
A
A
v
A
w
a
a
a
a
a
a
a
"}
(61,1,1) = {"
a
a
a
a
a
a
a
a
a
a
a
a
a
a
a
a
a
a
w
A
A
A
A
A
A
A
v
A
A
A
A
A
v
A
A
A
v
v
v
A
A
A
v
A
w
a
a
a
a
a
a
a
"}
(62,1,1) = {"
a
a
a
a
a
a
a
a
a
a
a
a
a
a
a
a
a
a
w
A
A
A
A
A
A
A
v
A
A
A
A
A
v
A
A
A
A
T
A
A
A
A
v
A
w
a
a
a
a
a
a
a
"}
(63,1,1) = {"
a
a
a
a
a
a
a
a
a
a
a
a
a
a
a
a
a
a
w
A
v
A
A
A
A
A
A
v
A
A
A
v
v
v
A
A
v
v
A
A
A
A
v
A
w
a
a
a
a
a
a
a
"}
(64,1,1) = {"
a
a
a
a
a
a
a
a
a
a
a
a
a
a
a
a
a
a
w
A
v
A
A
A
A
A
A
v
A
A
A
A
v
A
A
v
T
A
A
v
A
A
A
A
w
a
a
a
a
a
a
a
"}
(65,1,1) = {"
a
a
a
a
a
a
a
a
a
a
a
a
a
a
a
a
a
a
w
A
v
A
A
A
A
A
v
A
A
A
A
A
A
A
A
A
A
v
v
A
v
A
v
A
w
a
a
a
a
a
a
a
"}
(66,1,1) = {"
a
a
a
a
a
a
a
a
a
a
a
a
a
a
a
a
a
a
w
A
v
A
A
A
A
A
A
A
A
A
A
A
v
A
A
A
A
A
A
A
v
A
v
A
w
a
a
a
a
a
a
a
"}
(67,1,1) = {"
a
a
a
a
a
a
a
a
a
a
a
a
a
a
a
a
a
a
w
A
A
A
A
A
A
A
A
A
A
A
A
A
A
A
A
A
A
A
A
A
v
A
A
A
w
a
a
a
a
a
a
a
"}
(68,1,1) = {"
a
a
a
a
a
a
a
a
a
a
a
a
a
a
a
a
a
a
w
A
A
A
A
A
A
A
A
A
A
A
A
A
A
A
A
A
A
A
A
A
A
A
v
A
w
a
a
a
a
a
a
a
"}
(69,1,1) = {"
a
a
a
a
a
a
a
a
a
a
a
a
a
a
a
a
a
a
w
A
v
A
A
A
A
A
A
A
A
A
A
A
v
A
A
A
A
A
v
A
A
A
v
A
w
a
a
a
a
a
a
a
"}
(70,1,1) = {"
a
a
a
a
a
a
a
a
a
a
a
a
a
a
a
a
a
a
w
A
v
A
A
A
A
A
A
v
A
A
A
A
v
A
A
A
A
v
v
A
A
A
v
A
w
a
a
a
a
a
a
a
"}
(71,1,1) = {"
a
a
a
a
a
a
a
a
a
a
a
a
a
a
a
a
a
a
w
A
v
A
A
A
A
v
v
v
A
A
A
A
A
v
v
v
v
v
A
A
A
A
v
A
w
a
a
a
a
a
a
a
"}
(72,1,1) = {"
a
a
a
a
a
a
a
a
a
a
a
a
a
a
a
a
a
a
w
A
A
A
A
A
A
A
v
v
v
v
A
A
v
A
A
A
v
A
A
A
A
A
v
A
w
a
a
a
a
a
a
a
"}
(73,1,1) = {"
a
a
a
a
a
a
a
a
a
a
a
a
a
a
a
a
a
a
w
A
A
A
A
A
A
A
A
A
A
v
v
v
v
A
A
A
A
A
A
A
A
v
v
A
w
a
a
a
a
a
a
a
"}
(74,1,1) = {"
a
a
a
a
a
a
a
a
a
a
a
a
a
a
a
a
a
a
w
A
A
A
A
A
A
A
A
A
A
A
A
A
v
A
A
A
A
A
A
A
A
A
A
A
w
a
a
a
a
a
a
a
"}
(75,1,1) = {"
a
a
a
a
a
a
a
a
a
a
a
a
a
a
a
a
a
a
w
A
v
A
A
A
A
A
A
A
A
A
A
A
A
A
A
A
A
A
A
A
A
A
A
A
w
a
a
a
a
a
a
a
"}
(76,1,1) = {"
a
a
a
a
a
a
a
a
a
a
a
a
a
a
a
a
a
a
w
A
v
v
A
A
A
A
A
A
A
A
A
A
A
A
A
A
A
A
A
A
A
A
A
A
w
a
a
a
a
a
a
a
"}
(77,1,1) = {"
a
a
a
a
a
a
a
a
a
a
a
a
a
a
a
a
a
a
w
A
A
A
A
A
A
A
A
A
A
A
A
A
A
A
A
A
A
A
A
A
A
A
A
A
w
a
a
a
a
a
a
a
"}
(78,1,1) = {"
a
a
a
a
a
a
a
a
a
a
a
a
a
a
a
a
a
a
w
A
A
v
A
A
A
A
A
A
v
v
v
A
A
v
v
v
A
v
v
A
v
T
A
A
w
a
a
a
a
a
a
a
"}
(79,1,1) = {"
a
a
a
a
a
a
a
a
a
a
a
a
a
a
a
a
a
a
w
A
A
A
v
v
T
A
A
A
v
A
A
A
v
A
A
A
v
A
A
A
A
A
A
A
w
a
a
a
a
a
a
a
"}
(80,1,1) = {"
a
a
a
a
a
a
a
a
a
a
a
a
a
a
a
a
a
a
w
A
A
A
A
A
A
A
A
A
A
A
A
A
A
A
A
A
A
A
A
A
A
A
A
A
w
a
a
a
a
a
a
a
"}
(81,1,1) = {"
a
a
a
a
a
a
a
a
a
a
a
a
a
a
a
a
a
a
w
v
A
A
A
A
A
A
A
A
A
A
A
A
A
A
A
A
A
A
A
A
A
A
A
A
w
a
a
a
a
a
a
a
"}
(82,1,1) = {"
a
a
a
a
a
a
a
a
a
a
a
a
a
a
a
a
a
a
w
w
w
w
w
w
w
w
w
w
w
w
w
w
w
w
w
w
w
w
w
w
w
w
w
w
w
a
a
a
a
a
a
a
"}
(83,1,1) = {"
a
a
a
a
a
a
a
a
a
a
a
a
a
a
a
a
a
a
a
a
a
a
a
a
a
a
a
a
a
a
a
a
a
a
a
a
a
a
a
a
a
a
a
a
a
a
a
a
a
a
a
a
"}
(84,1,1) = {"
a
a
a
a
a
a
a
a
a
a
a
a
a
a
a
a
a
a
a
a
a
a
a
a
a
a
a
a
a
a
a
a
a
a
a
a
a
a
a
a
a
a
a
a
a
a
a
a
a
a
a
a
"}
(85,1,1) = {"
a
a
a
a
a
a
a
a
a
a
a
a
a
a
a
a
a
a
a
a
a
a
a
a
a
a
a
a
a
a
a
a
a
a
a
a
a
a
a
a
a
a
a
a
a
a
a
a
a
a
a
a
"}
(86,1,1) = {"
a
a
a
a
a
a
a
a
a
a
a
a
a
a
a
a
a
a
a
a
a
a
a
a
a
a
a
a
a
a
a
a
a
a
a
a
a
a
a
a
a
a
a
a
a
a
a
a
a
a
a
a
"}
(87,1,1) = {"
a
a
a
a
a
a
a
a
a
a
a
a
a
a
a
a
a
a
a
a
a
a
a
a
a
a
a
a
a
a
a
a
a
a
a
a
a
a
a
a
a
a
a
a
a
a
a
a
a
a
a
a
"}
(88,1,1) = {"
a
a
a
a
a
a
a
a
a
a
a
a
a
a
a
a
a
a
a
a
a
a
a
a
a
a
a
a
a
a
a
a
a
a
a
a
a
a
a
a
a
a
a
a
a
a
a
a
a
a
a
a
"}
(89,1,1) = {"
a
a
a
a
a
a
a
a
a
a
a
a
a
a
a
a
a
a
a
a
a
a
a
a
a
a
a
a
a
a
a
a
a
a
a
a
a
a
a
a
a
a
a
a
a
a
a
a
a
a
a
a
"}
(90,1,1) = {"
a
a
a
a
a
a
a
a
a
a
a
a
a
a
a
a
a
a
a
a
a
a
a
a
a
a
a
a
a
a
a
a
a
a
a
a
a
a
a
a
a
a
a
a
a
a
a
a
a
a
a
a
"}
