//MAP CONVERTED BY dmm2tgm.py THIS HEADER COMMENT PREVENTS RECONVERSION, DO NOT REMOVE
"a" = (
/obj/effect/decal/cleanable/dirt/dust,
/obj/effect/decal/cleanable/dirt/dust,
/obj/effect/decal/cleanable/dirt/dust,
/obj/structure/mineral_door/gold,
/turf/open/floor/plasteel/patterned/brushed,
/area/ship/bridge)
"b" = (
/obj/structure/chair/comfy/shuttle{
	dir = 1
	},
/obj/structure/railing{
	dir = 8
	},
/obj/machinery/light/directional/south,
/obj/effect/decal/cleanable/dirt/dust,
/obj/effect/decal/cleanable/dirt/dust,
/obj/effect/decal/cleanable/dirt/dust,
/turf/open/floor/plasteel/dark,
/area/ship/bridge)
"c" = (
/turf/template_noop,
/area/template_noop)
"d" = (
/obj/structure/window/plasma/reinforced/plastitanium,
/obj/machinery/door/poddoor/shutters{
	id = "nail_window_shut"
	},
/obj/structure/grille,
/obj/machinery/door/firedoor/border_only{
	dir = 8
	},
/obj/machinery/door/firedoor/border_only,
/obj/structure/cable{
	icon_state = "4-8"
	},
/turf/open/floor/plating,
/area/ship/bridge)
"e" = (
/obj/structure/railing{
	dir = 8
	},
/obj/effect/decal/cleanable/dirt/dust,
/obj/effect/decal/cleanable/dirt/dust,
/turf/open/floor/plasteel/tech,
/area/ship/bridge)
"h" = (
/obj/structure/cable{
	icon_state = "4-8"
	},
/obj/effect/decal/cleanable/dirt/dust,
/obj/effect/decal/cleanable/dirt/dust,
/obj/effect/decal/cleanable/dirt/dust,
/turf/open/floor/plating/rust,
/area/ship/bridge)
"i" = (
/obj/structure/railing{
	dir = 8
	},
/turf/open/floor/plating/rust,
/area/ship/bridge)
"k" = (
/obj/effect/decal/cleanable/dirt/dust,
/obj/effect/decal/cleanable/dirt/dust,
/obj/effect/decal/cleanable/dirt/dust,
/turf/open/floor/plasteel/tech,
/area/ship/bridge)
"l" = (
/obj/structure/railing/corner,
/obj/machinery/power/smes/engineering,
/obj/structure/cable{
	icon_state = "0-4"
	},
/obj/structure/cable{
	icon_state = "0-2"
	},
/turf/open/floor/plasteel/tech,
/area/ship/bridge)
"o" = (
/obj/machinery/button/door{
	id = "nail_window_shut";
	name = "Nail Window Shutters";
	dir = 1;
	pixel_y = -20;
	pixel_x = 5
	},
/obj/machinery/light_switch{
	dir = 1;
	pixel_x = -8;
	pixel_y = -19
	},
/obj/structure/chair/comfy/shuttle{
	dir = 8
	},
/turf/open/floor/plasteel/telecomms_floor,
/area/ship/bridge)
"p" = (
/obj/structure/mineral_door/gold,
/turf/open/floor/plasteel/patterned/brushed,
/area/ship/bridge)
"r" = (
/obj/structure/cable{
	icon_state = "4-8"
	},
/obj/structure/cable{
	icon_state = "2-8"
	},
/obj/structure/cable{
	icon_state = "1-8"
	},
/obj/effect/decal/cleanable/blood/gibs/down,
/turf/open/floor/plasteel/patterned/brushed,
/area/ship/bridge)
"s" = (
/turf/open/floor/plating/rust,
/area/ship/bridge)
"t" = (
/turf/closed/wall/mineral/sandstone,
/area/ship/bridge)
"u" = (
/obj/structure/cable{
	icon_state = "4-8"
	},
/obj/effect/decal/cleanable/dirt/dust,
/obj/effect/decal/cleanable/dirt/dust,
/turf/open/floor/plating,
/area/ship/bridge)
"v" = (
/obj/structure/chair/comfy/shuttle{
	dir = 1
	},
/obj/structure/cable{
	icon_state = "1-2"
	},
/turf/open/floor/plating,
/area/ship/bridge)
"w" = (
/obj/structure/railing/corner{
	dir = 1
	},
/obj/structure/cable{
	icon_state = "0-8"
	},
/obj/structure/catwalk/over/plated_catwalk/dark,
/turf/open/floor/plating,
/area/ship/bridge)
"x" = (
/obj/structure/railing{
	dir = 4
	},
/obj/structure/closet/emcloset/wall/directional/north,
/obj/effect/decal/cleanable/dirt/dust,
/turf/open/floor/plating,
/area/ship/bridge)
"y" = (
/obj/structure/window/plasma/reinforced/plastitanium,
/obj/machinery/door/poddoor/shutters{
	id = "nail_window_shut"
	},
/obj/structure/grille,
/obj/machinery/door/firedoor/border_only{
	dir = 4
	},
/obj/machinery/door/firedoor/border_only{
	dir = 1
	},
/obj/structure/cable{
	icon_state = "1-8"
	},
/turf/open/floor/plating,
/area/ship/bridge)
"z" = (
/obj/machinery/power/apc/auto_name/directional/north,
/obj/structure/cable{
	icon_state = "0-2"
	},
/obj/structure/catwalk/over/plated_catwalk/dark,
/turf/open/floor/plating,
/area/ship/bridge)
"A" = (
/obj/structure/railing,
/obj/structure/cable{
	icon_state = "1-8"
	},
/obj/structure/cable{
	icon_state = "4-8"
	},
/obj/structure/catwalk/over/plated_catwalk/dark,
/obj/effect/decal/cleanable/insectguts,
/turf/open/floor/plating,
/area/ship/bridge)
"B" = (
/obj/structure/railing/corner{
	dir = 8
	},
/obj/structure/cable{
	icon_state = "0-8"
	},
/obj/structure/catwalk/over/plated_catwalk/dark,
/turf/open/floor/plating,
/area/ship/bridge)
"D" = (
/obj/structure/cable/blue{
	icon_state = "0-4"
	},
/obj/structure/frame{
	anchored = 1
	},
/turf/open/floor/plating,
/area/ship/bridge)
"E" = (
/obj/structure/chair/comfy/shuttle,
/obj/structure/cable{
	icon_state = "1-2"
	},
/turf/open/floor/plasteel/dark,
/area/ship/bridge)
"H" = (
/obj/structure/cable{
	icon_state = "0-4"
	},
/obj/structure/catwalk/over/plated_catwalk/dark,
/obj/machinery/light/directional/west,
/obj/item/wrench,
/obj/structure/frame,
/turf/open/floor/plating,
/area/ship/bridge)
"I" = (
/obj/machinery/computer/helm{
	dir = 4
	},
/obj/item/radio/intercom/wideband/directional/south{
	pixel_x = 6;
	pixel_y = -29
	},
/obj/machinery/newscaster/directional/south{
	pixel_x = -9
	},
/turf/open/floor/plasteel/telecomms_floor,
/area/ship/bridge)
"J" = (
/obj/structure/cable{
	icon_state = "2-8"
	},
/obj/structure/cable{
	icon_state = "1-8"
	},
/obj/docking_port/mobile{
	dir = 8;
	name = "nail dock";
	preferred_direction = 8;
	port_direction = 2
	},
/obj/structure/mineral_door/gold,
/turf/open/floor/plasteel/patterned/brushed,
/area/ship/bridge)
"L" = (
/obj/structure/cable/blue{
	icon_state = "0-4"
	},
/obj/structure/frame{
	anchored = 1
	},
/turf/open/floor/plasteel/tech,
/area/ship/bridge)
"M" = (
/obj/structure/window/plasma/reinforced/plastitanium,
/obj/structure/grille,
/obj/machinery/door/firedoor/border_only{
	dir = 8
	},
/obj/machinery/door/firedoor/border_only,
/obj/machinery/door/poddoor/shutters{
	id = "nail_window_shut"
	},
/turf/open/floor/plating,
/area/ship/bridge)
"N" = (
/obj/structure/cable{
	icon_state = "4-8"
	},
/obj/effect/decal/cleanable/dirt/dust,
/obj/effect/decal/cleanable/dirt/dust,
/turf/open/floor/plasteel/patterned/brushed,
/area/ship/bridge)
"O" = (
/obj/structure/railing,
/obj/structure/catwalk/over/plated_catwalk/dark,
/obj/structure/cable{
	icon_state = "2-4"
	},
/obj/structure/rack,
/turf/open/floor/plating,
/area/ship/bridge)
"P" = (
/turf/closed/wall/rust,
/area/ship/bridge)
"R" = (
/obj/structure/railing{
	dir = 1
	},
/obj/structure/cable{
	icon_state = "1-4"
	},
/obj/structure/catwalk/over/plated_catwalk/dark,
/obj/structure/closet/crate,
/obj/item/holosign_creator/atmos,
/turf/open/floor/plating,
/area/ship/bridge)
"S" = (
/obj/machinery/holopad/emergency,
/obj/structure/cable{
	icon_state = "4-8"
	},
/obj/effect/decal/cleanable/dirt/dust,
/turf/open/floor/plasteel/patterned/brushed,
/area/ship/bridge)
"T" = (
/obj/structure/cable{
	icon_state = "0-4"
	},
/obj/machinery/porta_turret/ship/frontiersmen/light,
/turf/open/floor/engine/hull/reinforced/interior,
/area/ship/bridge)
"U" = (
/obj/structure/chair/comfy/shuttle,
/obj/machinery/light/directional/north,
/obj/effect/decal/cleanable/dirt/dust,
/obj/effect/decal/cleanable/dirt/dust,
/obj/effect/decal/cleanable/dirt/dust,
/turf/open/floor/plasteel/dark,
/area/ship/bridge)
"V" = (
/obj/structure/cable/blue{
	icon_state = "0-8"
	},
/obj/machinery/door/firedoor/border_only{
	dir = 8
	},
/obj/structure/frame{
	anchored = 1
	},
/turf/open/floor/plating,
/area/ship/bridge)
"W" = (
/turf/closed/wall/mineral/wood,
/area/ship/bridge)
"X" = (
/obj/structure/cable{
	icon_state = "0-8"
	},
/obj/machinery/power/terminal,
/obj/structure/catwalk/over/plated_catwalk/dark,
/obj/machinery/airalarm/directional/north,
/turf/open/floor/plating,
/area/ship/bridge)

(1,1,1) = {"
c
t
t
t
T
c
c
"}
(2,1,1) = {"
c
t
H
P
d
c
c
"}
(3,1,1) = {"
c
P
X
l
y
M
c
"}
(4,1,1) = {"
c
P
z
A
I
W
c
"}
(5,1,1) = {"
c
P
x
S
o
W
c
"}
(6,1,1) = {"
W
P
U
h
b
P
P
"}
(7,1,1) = {"
W
O
E
r
v
R
W
"}
(8,1,1) = {"
W
B
i
u
e
w
W
"}
(9,1,1) = {"
W
D
k
N
s
L
P
"}
(10,1,1) = {"
c
V
p
J
a
V
c
"}
