//MAP CONVERTED BY dmm2tgm.py THIS HEADER COMMENT PREVENTS RECONVERSION, DO NOT REMOVE
"bm" = (
/obj/effect/turf_decal/techfloor{
	dir = 8
	},
/obj/effect/turf_decal/industrial/hatch{
	color = "#eeac2e"
	},
/turf/open/floor/plasteel/tech,
/area/ship/bridge)
"cI" = (
/obj/machinery/holopad/emergency/command{
	pixel_x = 1;
	pixel_y = -15
	},
/obj/effect/turf_decal/techfloor{
	dir = 4
	},
/obj/effect/turf_decal/trimline/opaque/solgovgold/filled/line{
	dir = 8
	},
/turf/open/floor/plasteel/white,
/area/ship/bridge)
"cQ" = (
/obj/machinery/power/shuttle/engine/electric,
/obj/structure/cable{
	icon_state = "0-4"
	},
/turf/open/floor/plating,
/area/ship/bridge)
"fB" = (
/obj/effect/decal/cleanable/dirt/dust,
/turf/closed/wall/mineral/titanium/nodiagonal,
/area/ship/bridge)
"gw" = (
/obj/structure/cable{
	icon_state = "4-8"
	},
/obj/effect/turf_decal/techfloor{
	dir = 4
	},
/obj/effect/turf_decal/trimline/opaque/solgovgold/filled/corner{
	dir = 1
	},
/turf/open/floor/plasteel/white,
/area/ship/bridge)
"gZ" = (
/obj/machinery/porta_turret/ship/solfed/heavy{
	dir = 10;
	id = "vespa_turrets"
	},
/turf/closed/wall/mineral/titanium,
/area/ship/bridge)
"hi" = (
/obj/structure/cable{
	icon_state = "4-8"
	},
/obj/item/banner/solfed/mundane{
	anchored = 1
	},
/obj/machinery/light/floor,
/turf/open/floor/plasteel/tech/grid,
/area/ship/bridge)
"hE" = (
/obj/machinery/door/poddoor/shutters/preopen{
	id = "vespa_windows";
	dir = 4
	},
/obj/structure/grille,
/obj/structure/window/reinforced/fulltile/shuttle,
/obj/structure/cable,
/turf/open/floor/plating,
/area/ship/bridge)
"kf" = (
/obj/structure/cable{
	icon_state = "1-2"
	},
/obj/effect/turf_decal/techfloor{
	dir = 5
	},
/turf/open/floor/plasteel/tech,
/area/ship/bridge)
"mz" = (
/obj/effect/turf_decal/techfloor{
	dir = 4
	},
/obj/effect/turf_decal/trimline/opaque/solgovgold/filled/corner{
	dir = 8
	},
/obj/effect/decal/cleanable/dirt,
/turf/open/floor/plasteel/white,
/area/ship/bridge)
"pr" = (
/obj/effect/turf_decal/techfloor{
	dir = 9
	},
/obj/effect/decal/cleanable/dirt,
/turf/open/floor/plasteel/tech,
/area/ship/bridge)
"pE" = (
/obj/machinery/door/poddoor/shutters/preopen{
	id = "vespa_windows";
	dir = 4
	},
/obj/structure/grille,
/obj/structure/window/reinforced/fulltile/shuttle,
/obj/structure/cable{
	icon_state = "0-2"
	},
/turf/open/floor/plating,
/area/ship/bridge)
"pR" = (
/obj/structure/cable{
	icon_state = "4-8"
	},
/obj/effect/turf_decal/trimline/opaque/solgovblue/filled/corner{
	dir = 1
	},
/obj/effect/turf_decal/industrial/stand_clear{
	color = "#eeac2e"
	},
/turf/open/floor/plasteel/white,
/area/ship/bridge)
"qm" = (
/obj/structure/sign/solfed,
/turf/closed/wall/mineral/titanium,
/area/ship/bridge)
"rZ" = (
/obj/structure/cable{
	icon_state = "2-4"
	},
/obj/effect/turf_decal/techfloor{
	dir = 10
	},
/turf/open/floor/plasteel/tech,
/area/ship/bridge)
"st" = (
/obj/structure/cable{
	icon_state = "1-2"
	},
/obj/structure/cable{
	icon_state = "2-4"
	},
/obj/effect/turf_decal/trimline/opaque/solgovblue/filled/corner,
/obj/effect/decal/cleanable/dirt,
/turf/open/floor/plasteel/white,
/area/ship/bridge)
"sN" = (
/obj/machinery/light/floor,
/obj/effect/turf_decal/trimline/opaque/solgovblue/filled/line,
/obj/structure/chair/comfy/shuttle{
	dir = 1
	},
/obj/effect/turf_decal/techfloor{
	dir = 4
	},
/obj/structure/cable{
	icon_state = "4-8"
	},
/turf/open/floor/plasteel/white,
/area/ship/bridge)
"tv" = (
/obj/machinery/porta_turret/ship/solfed/heavy{
	dir = 5;
	id = "vespa_turrets"
	},
/turf/closed/wall/mineral/titanium,
/area/ship/bridge)
"uC" = (
/obj/structure/cable{
	icon_state = "1-8"
	},
/obj/structure/cable{
	icon_state = "1-2"
	},
/obj/effect/turf_decal/trimline/opaque/solgovblue/filled/corner{
	dir = 4
	},
/obj/effect/decal/cleanable/dirt,
/turf/open/floor/plasteel/white,
/area/ship/bridge)
"uI" = (
/obj/structure/cable{
	icon_state = "1-2"
	},
/obj/effect/turf_decal/trimline/opaque/solgovblue/filled/corner{
	dir = 8
	},
/obj/effect/turf_decal/trimline/opaque/solgovblue/filled/corner{
	dir = 1
	},
/obj/effect/turf_decal/trimline/opaque/solgovgold/filled/corner{
	dir = 4
	},
/obj/structure/window/reinforced/survival_pod{
	dir = 9
	},
/turf/open/floor/plasteel/white,
/area/ship/bridge)
"vO" = (
/obj/machinery/power/smes/shuttle/precharged,
/obj/machinery/door/poddoor/shutters{
	id = "vespa_thr";
	dir = 4
	},
/obj/structure/window/reinforced/spawner/west,
/obj/structure/cable{
	icon_state = "0-8"
	},
/turf/open/floor/plating,
/area/ship/bridge)
"zm" = (
/obj/machinery/telecomms/relay{
	network = "SolNet";
	autolinkers = list("SolHub")
	},
/obj/machinery/light/floor,
/obj/machinery/turretid{
	pixel_x = -2;
	pixel_y = 26;
	id = "vespa_turrets"
	},
/obj/effect/turf_decal/industrial/outline/yellow{
	color = "#eeac2e"
	},
/turf/open/floor/plasteel/tech/grid,
/area/ship/bridge)
"zX" = (
/obj/machinery/door/poddoor/shutters/preopen{
	id = "vespa_windows";
	dir = 4
	},
/obj/structure/grille,
/obj/structure/window/reinforced/fulltile/shuttle,
/obj/structure/cable{
	icon_state = "1-2"
	},
/obj/structure/cable{
	icon_state = "0-2"
	},
/turf/open/floor/plating,
/area/ship/bridge)
"Am" = (
/obj/machinery/power/smes/engineering{
	charge = 4e+006
	},
/obj/structure/cable{
	icon_state = "0-4"
	},
/obj/structure/cable{
	icon_state = "0-6"
	},
/obj/effect/turf_decal/trimline/opaque/solgovblue/filled/end{
	dir = 8
	},
/obj/structure/window/reinforced/survival_pod,
/turf/open/floor/plasteel/lightdark,
/area/ship/bridge)
"AH" = (
/obj/effect/turf_decal/spline/fancy/opaque/black{
	dir = 4
	},
/turf/open/floor/plasteel/patterned/brushed,
/area/ship/bridge)
"AK" = (
/turf/closed/wall/mineral/titanium/nodiagonal,
/area/ship/bridge)
"AX" = (
/obj/machinery/power/terminal{
	dir = 8
	},
/obj/structure/cable{
	icon_state = "2-9"
	},
/obj/structure/cable{
	icon_state = "0-2"
	},
/obj/effect/turf_decal/trimline/opaque/solgovblue/filled/line{
	dir = 8
	},
/obj/effect/turf_decal/trimline/opaque/solgovgold/filled/line{
	dir = 4
	},
/obj/machinery/door/window/survival_pod{
	dir = 8
	},
/turf/open/floor/plasteel/white,
/area/ship/bridge)
"Br" = (
/obj/structure/chair/comfy/shuttle{
	dir = 4;
	name = "helm shuttle chair"
	},
/obj/effect/turf_decal/spline/fancy/opaque/black{
	dir = 4
	},
/turf/open/floor/plasteel/patterned/brushed,
/area/ship/bridge)
"BW" = (
/turf/closed/wall/mineral/titanium,
/area/ship/bridge)
"Cu" = (
/obj/machinery/door/poddoor/shutters/preopen{
	id = "vespadoors"
	},
/obj/structure/fans/tiny,
/obj/structure/cable{
	icon_state = "1-2"
	},
/obj/effect/turf_decal/trimline/opaque/solgovgold/filled/warning,
/obj/effect/turf_decal/techfloor{
	dir = 1
	},
/turf/open/floor/plasteel/tech,
/area/ship/bridge)
"CJ" = (
/obj/machinery/door/poddoor/shutters/preopen{
	id = "vespa_windows";
	dir = 4
	},
/obj/structure/grille,
/obj/structure/window/reinforced/fulltile/shuttle,
/obj/structure/cable{
	icon_state = "0-8"
	},
/obj/structure/cable{
	icon_state = "2-8"
	},
/obj/structure/cable{
	icon_state = "1-8"
	},
/turf/open/floor/plating,
/area/ship/bridge)
"Dg" = (
/obj/effect/turf_decal/techfloor{
	dir = 8
	},
/obj/machinery/mineral/ore_redemption,
/obj/effect/turf_decal/industrial/outline/yellow{
	color = "#eeac2e"
	},
/turf/open/floor/plasteel/tech,
/area/ship/bridge)
"DW" = (
/obj/item/radio/intercom/wideband/directional{
	pixel_x = 31;
	pixel_y = -31
	},
/obj/structure/cable{
	icon_state = "4-8"
	},
/obj/structure/cable{
	icon_state = "2-8"
	},
/obj/effect/turf_decal/spline/fancy/opaque/black{
	dir = 4
	},
/obj/effect/decal/cleanable/dirt,
/turf/open/floor/plasteel/patterned/brushed,
/area/ship/bridge)
"DX" = (
/obj/machinery/porta_turret/ship/solfed/heavy{
	dir = 6;
	id = "vespa_turrets"
	},
/turf/closed/wall/mineral/titanium,
/area/ship/bridge)
"Ep" = (
/obj/machinery/door/poddoor/shutters/preopen{
	id = "vespadoors"
	},
/obj/structure/fans/tiny,
/obj/structure/cable{
	icon_state = "1-2"
	},
/obj/effect/turf_decal/trimline/opaque/solgovgold/filled/warning{
	dir = 1
	},
/obj/effect/turf_decal/techfloor,
/turf/open/floor/plasteel/tech,
/area/ship/bridge)
"EI" = (
/obj/machinery/computer/helm{
	dir = 8
	},
/obj/effect/turf_decal/box/white{
	color = "#eeac2e"
	},
/turf/open/floor/plasteel/tech/grid,
/area/ship/bridge)
"HC" = (
/obj/machinery/door/poddoor/shutters/preopen{
	id = "vespadoors"
	},
/obj/structure/fans/tiny,
/obj/effect/turf_decal/trimline/opaque/solgovgold/filled/warning,
/obj/effect/turf_decal/techfloor{
	dir = 1
	},
/turf/open/floor/plasteel/tech,
/area/ship/bridge)
"Je" = (
/obj/machinery/power/terminal{
	dir = 8
	},
/obj/structure/cable,
/obj/structure/cable{
	icon_state = "1-2"
	},
/obj/effect/turf_decal/trimline/opaque/solgovblue/filled/line{
	dir = 8
	},
/obj/effect/turf_decal/trimline/opaque/solgovgold/filled/line{
	dir = 4
	},
/obj/machinery/door/window/survival_pod{
	dir = 8
	},
/turf/open/floor/plasteel/white,
/area/ship/bridge)
"Lc" = (
/obj/machinery/porta_turret/ship/solfed/heavy{
	dir = 9;
	id = "vespa_turrets"
	},
/turf/closed/wall/mineral/titanium,
/area/ship/bridge)
"MF" = (
/turf/template_noop,
/area/template_noop)
"MX" = (
/obj/machinery/computer/crew{
	dir = 8
	},
/obj/effect/turf_decal/box/white{
	color = "#eeac2e"
	},
/turf/open/floor/plasteel/tech/grid,
/area/ship/bridge)
"Nn" = (
/obj/item/paper_bin{
	pixel_x = -7;
	pixel_y = 3
	},
/obj/item/folder/solgov{
	pixel_x = -7;
	pixel_y = 3
	},
/obj/item/pen/solgov{
	pixel_x = -7;
	pixel_y = 3
	},
/obj/machinery/button/door{
	id = "vespa_windows";
	name = "window shutters";
	pixel_x = 6;
	pixel_y = 8
	},
/obj/machinery/button/door{
	id = "vespadoors";
	name = "airlock shutters";
	pixel_x = 6;
	pixel_y = -2
	},
/obj/structure/table/reinforced/plastitaniumglass,
/obj/machinery/airalarm/directional/north{
	pixel_x = 0;
	pixel_y = 38
	},
/obj/effect/turf_decal/spline/fancy/opaque/black{
	dir = 4
	},
/turf/open/floor/plasteel/patterned/brushed,
/area/ship/bridge)
"OR" = (
/obj/structure/cable{
	icon_state = "1-2"
	},
/obj/effect/turf_decal/techfloor{
	dir = 4
	},
/obj/structure/crate_shelf,
/obj/effect/turf_decal/industrial/outline/yellow{
	color = "#eeac2e"
	},
/turf/open/floor/plasteel/tech,
/area/ship/bridge)
"Pk" = (
/obj/structure/cable{
	icon_state = "4-8"
	},
/obj/structure/cable{
	icon_state = "1-2"
	},
/obj/effect/turf_decal/techfloor{
	dir = 6
	},
/turf/open/floor/plasteel/tech,
/area/ship/bridge)
"PN" = (
/obj/effect/turf_decal/techfloor{
	dir = 4
	},
/obj/effect/turf_decal/trimline/opaque/solgovgold/filled/line{
	dir = 8
	},
/turf/open/floor/plasteel/white,
/area/ship/bridge)
"QF" = (
/obj/machinery/door/poddoor/shutters/preopen{
	id = "vespadoors"
	},
/obj/structure/fans/tiny,
/obj/docking_port/mobile{
	port_direction = 4;
	preferred_direction = 4;
	name = "rider"
	},
/obj/effect/turf_decal/trimline/opaque/solgovgold/filled/warning{
	dir = 1
	},
/obj/effect/turf_decal/techfloor,
/turf/open/floor/plasteel/tech,
/area/ship/bridge)
"Vp" = (
/obj/machinery/recharger{
	pixel_x = -6;
	pixel_y = 0
	},
/obj/machinery/recharger{
	pixel_x = 6;
	pixel_y = 0
	},
/obj/structure/table/reinforced/plastitaniumglass,
/obj/structure/cable{
	icon_state = "0-8"
	},
/obj/structure/cable{
	icon_state = "0-1"
	},
/obj/machinery/light_switch{
	pixel_y = -16;
	pixel_x = -12;
	dir = 1
	},
/obj/machinery/power/apc/auto_name/directional/south,
/obj/effect/turf_decal/spline/fancy/opaque/black{
	dir = 4
	},
/turf/open/floor/plasteel/patterned/brushed,
/area/ship/bridge)
"VB" = (
/obj/machinery/light/floor,
/obj/effect/turf_decal/trimline/opaque/solgovblue/filled/line{
	dir = 1
	},
/obj/structure/chair/comfy/shuttle,
/obj/effect/turf_decal/techfloor{
	dir = 4
	},
/turf/open/floor/plasteel/white,
/area/ship/bridge)
"WS" = (
/obj/structure/cable{
	icon_state = "1-8"
	},
/obj/effect/turf_decal/trimline/opaque/solgovblue/filled/corner{
	dir = 8
	},
/obj/effect/turf_decal/industrial/stand_clear{
	dir = 1;
	color = "#eeac2e"
	},
/turf/open/floor/plasteel/white,
/area/ship/bridge)
"XI" = (
/obj/machinery/power/terminal{
	dir = 8
	},
/obj/structure/cable,
/obj/effect/turf_decal/trimline/opaque/solgovblue/filled/corner{
	dir = 1
	},
/obj/effect/turf_decal/trimline/opaque/solgovblue/filled/corner{
	dir = 8
	},
/obj/effect/turf_decal/trimline/opaque/solgovgold/filled/corner,
/obj/structure/window/reinforced/survival_pod{
	dir = 10
	},
/turf/open/floor/plasteel/white,
/area/ship/bridge)
"XL" = (
/obj/structure/cable{
	icon_state = "1-2"
	},
/obj/effect/turf_decal/techfloor{
	dir = 4
	},
/obj/structure/ore_box,
/obj/effect/turf_decal/industrial/outline/yellow{
	color = "#eeac2e"
	},
/turf/open/floor/plasteel/tech,
/area/ship/bridge)
"Yr" = (
/obj/structure/closet/emcloset/wall/directional/west,
/obj/item/tank/internals/emergency_oxygen/double,
/obj/item/tank/internals/emergency_oxygen/double,
/obj/item/tank/internals/emergency_oxygen/double,
/obj/item/clothing/mask/breath,
/obj/item/clothing/mask/breath,
/obj/item/clothing/mask/breath,
/obj/item/storage/belt/utility/full/engi,
/obj/effect/turf_decal/trimline/opaque/solgovblue/filled/end{
	dir = 8
	},
/obj/effect/decal/cleanable/dirt,
/obj/structure/window/reinforced/survival_pod{
	dir = 1
	},
/turf/open/floor/plasteel/white,
/area/ship/bridge)
"ZR" = (
/obj/structure/cable{
	icon_state = "2-4"
	},
/obj/effect/turf_decal/trimline/opaque/solgovblue/filled/line{
	dir = 9
	},
/obj/machinery/light/floor,
/obj/structure/chair/comfy/shuttle,
/obj/machinery/button/door{
	pixel_x = -22;
	pixel_y = -6;
	id = "vespa_thr";
	name = "Thrusters doors";
	dir = 4
	},
/turf/open/floor/plasteel/white,
/area/ship/bridge)
"ZX" = (
/obj/structure/cable{
	icon_state = "1-4"
	},
/obj/effect/turf_decal/trimline/opaque/solgovblue/filled/line{
	dir = 10
	},
/obj/machinery/light/floor,
/obj/structure/chair/comfy/shuttle{
	dir = 1
	},
/turf/open/floor/plasteel/white,
/area/ship/bridge)

(1,1,1) = {"
MF
qm
BW
cQ
cQ
BW
qm
MF
"}
(2,1,1) = {"
Lc
AK
Am
vO
vO
Yr
AK
gZ
"}
(3,1,1) = {"
BW
ZR
XI
AX
Je
uI
ZX
BW
"}
(4,1,1) = {"
HC
pR
pr
Dg
bm
rZ
WS
QF
"}
(5,1,1) = {"
Cu
uC
kf
XL
OR
Pk
st
Ep
"}
(6,1,1) = {"
BW
VB
mz
cI
PN
gw
sN
BW
"}
(7,1,1) = {"
BW
Nn
AH
Br
Br
DW
Vp
BW
"}
(8,1,1) = {"
tv
AK
zm
EI
MX
hi
fB
DX
"}
(9,1,1) = {"
MF
pE
zX
zX
zX
CJ
hE
MF
"}
