//MAP CONVERTED BY dmm2tgm.py THIS HEADER COMMENT PREVENTS RECONVERSION, DO NOT REMOVE
"a" = (
/obj/structure/elevator_platform,
/obj/machinery/elevator_floor_button{
	pixel_y = 24;
	pixel_x = -8
	},
/turf/template_noop,
/area/template_noop)
"e" = (
/obj/structure/elevator_platform,
/obj/machinery/status_display/elevator{
	pixel_y = 32
	},
/turf/template_noop,
/area/template_noop)
"o" = (
/obj/structure/elevator_platform,
/obj/machinery/light/floor,
/turf/template_noop,
/area/template_noop)
"x" = (
/obj/structure/elevator_platform,
/turf/template_noop,
/area/template_noop)

(1,1,1) = {"
x
x
x
"}
(2,1,1) = {"
e
o
x
"}
(3,1,1) = {"
a
x
x
"}
