//MAP CONVERTED BY dmm2tgm.py THIS HEADER COMMENT PREVENTS RECONVERSION, DO NOT REMOVE
"aB" = (
/obj/structure/deployable_barricade/snow,
/turf/open/floor/plating{
	icon_state = "plating_rust"
	},
/area/overmap_encounter/planetoid/ice/explored)
"br" = (
/obj/item/shard{
	pixel_x = -11;
	pixel_y = -7
	},
/obj/item/shard{
	pixel_x = 15;
	pixel_y = 9
	},
/obj/item/stack/ore/salvage/scrapuranium/five{
	pixel_y = 10
	},
/mob/living/simple_animal/hostile/human/ramzi/ranged/space/shotgun/incendiary,
/turf/open/floor/plating,
/area/overmap_encounter/planetoid/ice/explored)
"ch" = (
/obj/structure/lattice,
/turf/open/floor/plating/asteroid/snow/icemoon,
/area/overmap_encounter/planetoid/ice/explored)
"cy" = (
/obj/item/wallframe/apc,
/obj/machinery/light/small/broken/directional/east,
/turf/open/floor/plasteel/patterned,
/area/overmap_encounter/planetoid/ice/explored)
"cE" = (
/obj/machinery/power/shuttle/engine/electric{
	dir = 1
	},
/turf/open/floor/plating/asteroid/snow/icemoon,
/area/overmap_encounter/planetoid/ice/explored)
"eX" = (
/obj/structure/frame/computer{
	dir = 4
	},
/obj/machinery/light/small/broken/directional/west,
/turf/open/floor/plating,
/area/overmap_encounter/planetoid/ice/explored)
"fn" = (
/obj/structure/frame,
/turf/open/floor/plating/asteroid/snow/icemoon,
/area/overmap_encounter/planetoid/ice/explored)
"fy" = (
/obj/item/stack/ore/salvage/scraptitanium/five,
/turf/open/floor/plating/asteroid/snow/icemoon,
/area/overmap_encounter/planetoid/ice/explored)
"fL" = (
/obj/machinery/door/airlock/highsecurity{
	locked = 212
	},
/turf/open/floor/plating{
	icon_state = "plating_rust"
	},
/area/overmap_encounter/planetoid/ice/explored)
"fS" = (
/obj/structure/lattice,
/turf/open/floor/plating/snowed/smoothed/icemoon,
/area/overmap_encounter/planetoid/ice/explored)
"gZ" = (
/obj/structure/girder/reinforced,
/obj/item/stack/sheet/mineral/titanium/five,
/turf/open/floor/plating,
/area/overmap_encounter/planetoid/ice/explored)
"in" = (
/obj/effect/decal/cleanable/blood/tracks,
/obj/structure/lattice,
/obj/item/mine/directional,
/obj/item/stack/ore/salvage/scrapbluespace,
/turf/open/floor/plating/snowed/smoothed/icemoon,
/area/overmap_encounter/planetoid/ice/explored)
"jj" = (
/obj/item/mine/directional,
/obj/item/stack/sheet/mineral/titanium/five,
/turf/open/floor/plating/asteroid/snow/icemoon,
/area/overmap_encounter/planetoid/ice/explored)
"kJ" = (
/obj/structure/deployable_barricade/snow,
/turf/open/floor/plating/snowed/smoothed/icemoon,
/area/overmap_encounter/planetoid/ice/explored)
"mw" = (
/obj/structure/table_frame,
/mob/living/simple_animal/hostile/human/ramzi/ranged/space/smg,
/turf/open/floor/plasteel/patterned,
/area/overmap_encounter/planetoid/ice/explored)
"nt" = (
/obj/effect/decal/cleanable/blood/old,
/obj/effect/mob_spawn/human/corpse/vigilitas_private,
/turf/open/floor/plating/asteroid/snow/icemoon,
/area/overmap_encounter/planetoid/ice/explored)
"oF" = (
/obj/structure/door_assembly/door_assembly_com,
/turf/open/floor/plating/asteroid/snow/icemoon,
/area/overmap_encounter/planetoid/ice/explored)
"qD" = (
/obj/item/stack/ore/salvage/scrapmetal/five,
/turf/open/floor/plating/asteroid/snow/icemoon,
/area/overmap_encounter/planetoid/ice/explored)
"rh" = (
/obj/item/stack/ore/salvage/scrapuranium/five,
/turf/open/floor/plating{
	icon_state = "platingdmg2"
	},
/area/overmap_encounter/planetoid/ice/explored)
"rm" = (
/obj/effect/decal/cleanable/oil/slippery,
/turf/open/floor/plating/asteroid/snow/icemoon,
/area/overmap_encounter/planetoid/ice/explored)
"rz" = (
/obj/structure/girder/reinforced,
/turf/open/floor/plating,
/area/overmap_encounter/planetoid/ice/explored)
"rR" = (
/obj/effect/decal/cleanable/blood/footprints,
/turf/closed/wall/mineral/titanium,
/area/overmap_encounter/planetoid/ice/explored)
"sa" = (
/mob/living/simple_animal/hostile/asteroid/hivelord/legion/snow{
	faction = list("Syndicate")
	},
/turf/open/floor/plating/snowed/smoothed/icemoon,
/area/overmap_encounter/planetoid/ice/explored)
"tq" = (
/obj/effect/decal/cleanable/blood/tracks,
/obj/structure/deployable_barricade/snow,
/turf/open/floor/plating{
	icon_state = "platingdmg3"
	},
/area/overmap_encounter/planetoid/ice/explored)
"tD" = (
/obj/structure/deployable_barricade/snow{
	dir = 8
	},
/obj/item/mine/directional,
/obj/item/stack/ore/salvage/scraptitanium/five,
/obj/item/stack/ore/rutile{
	pixel_x = 5;
	pixel_y = -4
	},
/turf/open/floor/plating/asteroid/snow/icemoon,
/area/overmap_encounter/planetoid/ice/explored)
"uD" = (
/obj/item/stack/sheet/mineral/titanium/five,
/turf/open/floor/plating{
	icon_state = "platingdmg1"
	},
/area/overmap_encounter/planetoid/ice/explored)
"vn" = (
/obj/structure/flora/grass/both,
/obj/item/stack/ore/salvage/scraptitanium/five,
/turf/open/floor/plating/asteroid/snow/icemoon,
/area/overmap_encounter/planetoid/ice/explored)
"wG" = (
/obj/structure/window/reinforced/spawner,
/obj/structure/table_frame,
/turf/open/floor/plating,
/area/overmap_encounter/planetoid/ice/explored)
"xF" = (
/obj/structure/toilet{
	color = "#ffd700"
	},
/obj/effect/mob_spawn/human/commander,
/obj/item/melee/sword/sabre,
/turf/open/floor/mineral/gold,
/area/overmap_encounter/planetoid/ice/explored)
"zb" = (
/turf/closed/indestructible/rock/snow,
/area/overmap_encounter/planetoid/ice/explored)
"Aa" = (
/obj/machinery/light/small/broken/directional/east,
/turf/open/floor/plating,
/area/overmap_encounter/planetoid/ice/explored)
"Al" = (
/obj/structure/deployable_barricade/snow,
/obj/effect/decal/cleanable/oil/slippery,
/turf/open/floor/plating/asteroid/snow/icemoon,
/area/overmap_encounter/planetoid/ice/explored)
"AH" = (
/obj/structure/lattice,
/obj/item/mine/directional,
/obj/item/stack/ore/salvage/scrapmetal/five,
/turf/open/floor/plating/asteroid/snow/icemoon,
/area/overmap_encounter/planetoid/ice/explored)
"CB" = (
/turf/open/floor/plating/asteroid/snow/icemoon,
/area/overmap_encounter/planetoid/ice/explored)
"Du" = (
/obj/item/stack/ore/salvage/scrapuranium/five,
/turf/open/floor/plating/asteroid/snow/icemoon,
/area/overmap_encounter/planetoid/ice/explored)
"DY" = (
/obj/item/stack/sheet/mineral/titanium/five,
/obj/structure/lattice,
/obj/structure/deployable_barricade/snow{
	dir = 8
	},
/turf/open/floor/plating/asteroid/snow/icemoon,
/area/overmap_encounter/planetoid/ice/explored)
"Fy" = (
/turf/open/floor/plating/snowed/smoothed/icemoon,
/area/overmap_encounter/planetoid/ice/explored)
"Ho" = (
/obj/structure/flora/rock/icy,
/turf/open/floor/plating/asteroid/snow/icemoon,
/area/overmap_encounter/planetoid/ice/explored)
"ID" = (
/obj/item/stack/sheet/mineral/titanium/five,
/turf/open/floor/plating/asteroid/snow/icemoon,
/area/overmap_encounter/planetoid/ice/explored)
"IY" = (
/obj/item/mine/directional/claymore,
/obj/item/stack/rods/ten{
	pixel_y = 5
	},
/turf/open/floor/plating,
/area/overmap_encounter/planetoid/ice/explored)
"Jj" = (
/obj/structure/flora/grass/both,
/turf/open/floor/plating/asteroid/snow/icemoon,
/area/overmap_encounter/planetoid/ice/explored)
"Js" = (
/turf/closed/wall/mineral/titanium,
/area/overmap_encounter/planetoid/ice/explored)
"KN" = (
/turf/open/floor/plating/ice/icemoon,
/area/overmap_encounter/planetoid/ice/explored)
"Mz" = (
/obj/structure/flora/rock/pile/icy,
/turf/open/floor/plating/asteroid/snow/icemoon,
/area/overmap_encounter/planetoid/ice/explored)
"MY" = (
/obj/structure/girder/reinforced,
/obj/item/stack/sheet/mineral/titanium/five,
/turf/open/floor/plating/asteroid/snow/icemoon,
/area/overmap_encounter/planetoid/ice/explored)
"OY" = (
/obj/structure/safe,
/obj/item/implanter/adrenalin,
/obj/item/implantcase/adrenaline,
/turf/open/floor/plasteel/patterned,
/area/overmap_encounter/planetoid/ice/explored)
"OZ" = (
/turf/open/floor/plasteel/patterned,
/area/overmap_encounter/planetoid/ice/explored)
"QJ" = (
/obj/item/organ/stomach,
/obj/structure/deployable_barricade/snow,
/turf/open/floor/plating/snowed/smoothed/icemoon,
/area/overmap_encounter/planetoid/ice/explored)
"Ra" = (
/turf/open/floor/plating{
	icon_state = "plating_rust"
	},
/area/overmap_encounter/planetoid/ice/explored)
"RZ" = (
/obj/effect/decal/cleanable/blood,
/mob/living/simple_animal/hostile/human/ramzi/ranged/space/smg,
/turf/open/floor/plasteel/patterned,
/area/overmap_encounter/planetoid/ice/explored)
"Sv" = (
/obj/structure/lattice,
/obj/structure/lattice,
/turf/open/floor/plating/asteroid/snow/icemoon,
/area/overmap_encounter/planetoid/ice/explored)
"Tq" = (
/obj/structure/deployable_barricade/snow{
	dir = 8
	},
/turf/open/floor/plating/asteroid/snow/icemoon,
/area/overmap_encounter/planetoid/ice/explored)
"Va" = (
/mob/living/simple_animal/hostile/asteroid/hivelord/legion/snow{
	faction = list("Syndicate")
	},
/turf/open/floor/plating/asteroid/snow/icemoon,
/area/overmap_encounter/planetoid/ice/explored)
"Ve" = (
/obj/item/organ/liver,
/turf/open/floor/plating/asteroid/snow/icemoon,
/area/overmap_encounter/planetoid/ice/explored)
"VG" = (
/turf/template_noop,
/area/template_noop)
"WO" = (
/obj/structure/table_frame/abductor,
/mob/living/simple_animal/hostile/human/ramzi/melee/space/sledge,
/turf/open/floor/plating,
/area/overmap_encounter/planetoid/ice/explored)
"XB" = (
/obj/structure/lattice,
/obj/structure/deployable_barricade/snow,
/turf/open/floor/plating/snowed/smoothed/icemoon,
/area/overmap_encounter/planetoid/ice/explored)
"XG" = (
/obj/item/stack/ore/salvage/scrapmetal,
/turf/open/floor/plating/snowed/smoothed/icemoon,
/area/overmap_encounter/planetoid/ice/explored)
"Zy" = (
/turf/open/floor/plating,
/area/overmap_encounter/planetoid/ice/explored)

(1,1,1) = {"
VG
VG
VG
VG
CB
CB
CB
CB
CB
VG
VG
VG
VG
VG
VG
VG
VG
VG
"}
(2,1,1) = {"
VG
VG
CB
CB
CB
CB
KN
KN
CB
Jj
CB
CB
CB
CB
CB
VG
VG
VG
"}
(3,1,1) = {"
VG
CB
CB
KN
KN
zb
KN
zb
zb
zb
zb
zb
CB
Va
CB
VG
VG
VG
"}
(4,1,1) = {"
VG
CB
KN
KN
zb
zb
zb
zb
zb
zb
KN
Mz
CB
Ho
CB
CB
VG
VG
"}
(5,1,1) = {"
VG
CB
KN
KN
zb
zb
zb
zb
zb
KN
KN
tD
Tq
CB
fy
CB
CB
VG
"}
(6,1,1) = {"
VG
CB
KN
zb
zb
zb
zb
zb
zb
sa
vn
fS
uD
aB
CB
CB
CB
VG
"}
(7,1,1) = {"
VG
CB
zb
zb
zb
zb
Js
Js
Js
Js
fS
cE
ch
XB
CB
CB
Mz
VG
"}
(8,1,1) = {"
CB
CB
zb
Js
gZ
Js
rz
eX
WO
MY
IY
QJ
XG
jj
Zy
rm
CB
VG
"}
(9,1,1) = {"
CB
zb
Js
xF
fL
RZ
wG
rh
CB
oF
in
tq
nt
CB
CB
Va
CB
VG
"}
(10,1,1) = {"
CB
zb
zb
Js
rR
Ra
OZ
br
Aa
kJ
Fy
Ra
Al
fn
CB
ID
CB
VG
"}
(11,1,1) = {"
CB
CB
zb
Js
OY
cy
mw
Js
Js
Js
fS
AH
kJ
ch
Zy
CB
CB
VG
"}
(12,1,1) = {"
VG
CB
zb
gZ
Js
Js
gZ
Js
zb
zb
zb
ch
DY
Sv
Ve
CB
CB
VG
"}
(13,1,1) = {"
VG
CB
zb
CB
zb
zb
zb
zb
zb
zb
zb
CB
CB
CB
qD
Jj
CB
VG
"}
(14,1,1) = {"
VG
CB
CB
CB
zb
zb
zb
zb
zb
zb
zb
zb
zb
CB
CB
CB
CB
VG
"}
(15,1,1) = {"
VG
CB
CB
KN
zb
KN
zb
zb
zb
KN
KN
Va
CB
CB
CB
CB
Ho
VG
"}
(16,1,1) = {"
VG
VG
CB
KN
KN
KN
zb
zb
KN
zb
CB
Du
Mz
CB
CB
fy
CB
VG
"}
(17,1,1) = {"
VG
VG
VG
CB
KN
CB
VG
VG
VG
Jj
CB
CB
VG
VG
VG
CB
VG
VG
"}
