//MAP CONVERTED BY dmm2tgm.py THIS HEADER COMMENT PREVENTS RECONVERSION, DO NOT REMOVE
"aR" = (
/obj/effect/turf_decal/corner/opaque/ntbluelight{
	dir = 8
	},
/turf/open/floor/plasteel/dark,
/area/ship/bridge)
"aT" = (
/obj/machinery/power/port_gen/pacman/super,
/obj/structure/cable{
	icon_state = "0-4"
	},
/turf/open/floor/plating,
/area/ship/engineering/electrical)
"aU" = (
/obj/structure/cable{
	icon_state = "4-8"
	},
/obj/structure/cable{
	icon_state = "1-8"
	},
/obj/structure/cable{
	icon_state = "2-8"
	},
/turf/open/floor/plating,
/area/ship/engineering)
"be" = (
/obj/structure/table/reinforced/titaniumglass,
/obj/item/toy/plush/celadon/stash_cherepanov,
/turf/open/floor/plasteel/dark,
/area/ship/bridge)
"bo" = (
/obj/effect/turf_decal/corner/opaque/ntbluelight/three_quarters{
	dir = 8
	},
/turf/open/floor/plasteel/dark,
/area/ship/bridge)
"bL" = (
/obj/structure/railing{
	dir = 1
	},
/turf/open/floor/concrete/reinforced,
/area/ship/cargo)
"bT" = (
/obj/machinery/power/shieldwallgen/atmos/roundstart{
	dir = 4;
	id = "monolith_shield_north"
	},
/obj/structure/cable{
	icon_state = "0-4"
	},
/obj/machinery/door/poddoor{
	id = "monolith_poddor_north"
	},
/turf/open/floor/plasteel/tech,
/area/ship/hallway/central)
"bW" = (
/obj/structure/cable{
	icon_state = "1-8"
	},
/obj/machinery/power/apc/auto_name/directional/north{
	pixel_y = 0;
	pixel_x = 25;
	dir = 4
	},
/obj/structure/cable{
	icon_state = "0-1"
	},
/obj/machinery/light_switch{
	pixel_x = 20;
	pixel_y = 11;
	dir = 8
	},
/turf/open/floor/plating,
/area/ship/engineering/engines)
"bX" = (
/obj/effect/turf_decal/corner/opaque/ntbluelight/bordercorner,
/turf/open/floor/plasteel/dark,
/area/ship/bridge)
"ct" = (
/obj/structure/table/reinforced/titaniumglass,
/turf/open/floor/plasteel/dark,
/area/ship/bridge)
"di" = (
/obj/structure/cable{
	icon_state = "1-2"
	},
/obj/structure/cable{
	icon_state = "1-8"
	},
/turf/open/floor/plating,
/area/ship/engineering/engines)
"dl" = (
/turf/open/floor/plating,
/area/ship/engineering/electrical)
"dp" = (
/obj/structure/table/reinforced/titaniumglass,
/obj/effect/turf_decal/corner/opaque/ntbluelight/full,
/turf/open/floor/plasteel/dark,
/area/ship/bridge)
"dH" = (
/obj/structure/chair/comfy/shuttle{
	name = "helm shuttle chair";
	dir = 8
	},
/turf/open/floor/plasteel/dark,
/area/ship/bridge)
"dO" = (
/obj/machinery/door/poddoor{
	id = "monolith_poddor_west";
	dir = 8
	},
/obj/machinery/power/shieldwallgen/atmos/roundstart{
	id = "monolith_shield_west";
	dir = 1
	},
/obj/structure/cable{
	icon_state = "0-1"
	},
/turf/open/floor/plasteel/tech,
/area/ship/hallway/central)
"dR" = (
/obj/effect/turf_decal/corner/opaque/ntbluelight{
	dir = 1
	},
/obj/structure/cable{
	icon_state = "1-8"
	},
/turf/open/floor/plasteel/dark,
/area/ship/bridge)
"eG" = (
/turf/open/floor/plating,
/area/ship/cargo)
"eS" = (
/obj/machinery/power/apc/auto_name/directional/north{
	pixel_y = 0;
	pixel_x = -25;
	dir = 8
	},
/obj/machinery/light_switch{
	pixel_x = -20;
	pixel_y = 11;
	dir = 4
	},
/obj/structure/cable{
	icon_state = "0-4"
	},
/turf/open/floor/plating,
/area/ship/engineering/electrical)
"fu" = (
/turf/closed/wall/mineral/titanium/exterior,
/area/ship/cargo)
"fv" = (
/obj/structure/cable{
	icon_state = "2-8"
	},
/turf/open/floor/plating,
/area/ship/engineering/electrical)
"fH" = (
/obj/machinery/computer/helm,
/obj/structure/cable{
	icon_state = "1-2"
	},
/turf/open/floor/plasteel/dark,
/area/ship/bridge)
"fK" = (
/obj/effect/turf_decal/corner/opaque/ntbluelight/bordercorner{
	dir = 1
	},
/turf/open/floor/plasteel/dark,
/area/ship/bridge)
"fZ" = (
/obj/effect/turf_decal/corner/opaque/ntbluelight/full,
/obj/structure/cable{
	icon_state = "2-8"
	},
/turf/open/floor/plasteel/dark,
/area/ship/bridge)
"ga" = (
/obj/structure/cable{
	icon_state = "1-8"
	},
/turf/open/floor/plating,
/area/ship/engineering)
"gh" = (
/obj/effect/turf_decal/corner/opaque/ntbluelight/bordercorner{
	dir = 1
	},
/obj/structure/cable{
	icon_state = "1-4"
	},
/turf/open/floor/plasteel/dark,
/area/ship/bridge)
"gB" = (
/obj/effect/turf_decal/corner/opaque/ntbluelight/three_quarters{
	dir = 1
	},
/obj/machinery/light/directional/west,
/turf/open/floor/plasteel/dark,
/area/ship/bridge)
"gJ" = (
/obj/effect/turf_decal/corner/opaque/ntbluelight/full,
/obj/effect/turf_decal/corner/opaque/white/diagonal,
/obj/structure/cable{
	icon_state = "2-8"
	},
/obj/structure/cable{
	icon_state = "1-2"
	},
/turf/open/floor/plasteel/dark,
/area/ship/bridge)
"gP" = (
/obj/structure/window/reinforced/fulltile,
/obj/machinery/door/poddoor/shutters{
	id = "bridge"
	},
/turf/open/floor/plating,
/area/ship/bridge)
"hd" = (
/obj/structure/cable{
	icon_state = "4-8"
	},
/turf/open/floor/plating,
/area/ship/engineering)
"hC" = (
/obj/effect/turf_decal/corner/opaque/ntbluelight/bordercorner{
	dir = 4
	},
/turf/open/floor/plasteel/dark,
/area/ship/bridge)
"hE" = (
/obj/effect/turf_decal/corner/opaque/ntbluelight/full,
/obj/effect/turf_decal/corner/opaque/white/half,
/turf/open/floor/plasteel/dark,
/area/ship/bridge)
"hL" = (
/obj/machinery/power/shieldwallgen/atmos/roundstart{
	dir = 8;
	id = "monolith_shield_south"
	},
/obj/machinery/door/poddoor{
	id = "monolith_poddor_south"
	},
/obj/structure/cable{
	icon_state = "0-8"
	},
/turf/open/floor/plasteel/tech,
/area/ship/hallway/central)
"hZ" = (
/obj/machinery/light/directional/west,
/turf/open/floor/plating,
/area/ship/engineering)
"id" = (
/obj/machinery/door/airlock/mining{
	dir = 1;
	name = "cargo airlock"
	},
/turf/open/floor/plating,
/area/ship/cargo)
"if" = (
/obj/effect/turf_decal/corner/opaque/ntbluelight/three_quarters{
	dir = 8
	},
/obj/machinery/cryopod{
	dir = 8
	},
/obj/machinery/computer/cryopod/directional{
	dir = 1;
	pixel_y = 26
	},
/turf/open/floor/plasteel/dark,
/area/ship/bridge)
"iA" = (
/turf/closed/wall/mineral/titanium/exterior,
/area/ship/bridge)
"iI" = (
/turf/closed/wall/mineral/titanium/exterior,
/area/ship/engineering)
"iT" = (
/obj/structure/sign/flag/nanotrasen/directional/east,
/turf/open/floor/plasteel/lightgrey,
/area/ship/hallway/central)
"iX" = (
/obj/machinery/power/terminal{
	dir = 8
	},
/obj/structure/cable{
	icon_state = "0-4"
	},
/turf/open/floor/plating,
/area/ship/engineering/engines)
"jo" = (
/obj/machinery/computer/mech_bay_power_console,
/turf/open/floor/plasteel/lightgrey,
/area/ship/cargo)
"jK" = (
/obj/effect/turf_decal/corner/opaque/ntbluelight{
	dir = 4
	},
/turf/open/floor/plasteel/dark,
/area/ship/bridge)
"jP" = (
/obj/effect/turf_decal/corner/opaque/ntbluelight/half{
	dir = 4
	},
/obj/machinery/light/directional/east,
/turf/open/floor/plasteel/dark,
/area/ship/bridge)
"km" = (
/obj/structure/chair/comfy/shuttle{
	name = "helm shuttle chair";
	dir = 4
	},
/turf/open/floor/plasteel/dark,
/area/ship/bridge)
"kr" = (
/obj/machinery/door/poddoor{
	id = "monolith_poddor_west";
	dir = 8
	},
/obj/structure/cable{
	icon_state = "1-2"
	},
/turf/open/floor/plasteel/tech,
/area/ship/hallway/central)
"kI" = (
/obj/effect/turf_decal/corner/opaque/ntbluelight/three_quarters{
	dir = 4
	},
/obj/structure/cable{
	icon_state = "0-2"
	},
/obj/machinery/power/apc/auto_name/directional/north,
/obj/machinery/light_switch{
	pixel_x = 11;
	pixel_y = 20
	},
/obj/machinery/light/directional/west,
/turf/open/floor/plasteel/dark,
/area/ship/bridge)
"kW" = (
/obj/machinery/door/airlock/command/glass{
	dir = 8
	},
/obj/effect/turf_decal/corner/opaque/ntbluelight/full,
/obj/structure/cable{
	icon_state = "4-8"
	},
/turf/open/floor/plasteel/dark,
/area/ship/bridge)
"la" = (
/obj/machinery/power/terminal{
	dir = 8
	},
/obj/structure/cable,
/obj/structure/cable{
	icon_state = "4-8"
	},
/turf/open/floor/plating,
/area/ship/engineering/electrical)
"lm" = (
/obj/structure/railing{
	dir = 5
	},
/turf/open/floor/concrete/reinforced,
/area/ship/cargo)
"lr" = (
/obj/effect/turf_decal/corner/opaque/ntbluelight,
/turf/closed/wall/mineral/titanium/exterior,
/area/ship/bridge)
"lt" = (
/obj/effect/turf_decal/corner/opaque/ntbluelight/half{
	dir = 8
	},
/obj/machinery/light/directional/west,
/turf/open/floor/plasteel/dark,
/area/ship/bridge)
"lR" = (
/obj/structure/railing,
/turf/open/floor/concrete/reinforced,
/area/ship/cargo)
"mB" = (
/obj/machinery/power/terminal{
	dir = 8
	},
/obj/structure/cable{
	icon_state = "1-2"
	},
/obj/structure/cable,
/obj/structure/cable{
	icon_state = "4-8"
	},
/turf/open/floor/plating,
/area/ship/engineering/electrical)
"mO" = (
/obj/machinery/button/door{
	pixel_x = -4;
	pixel_y = 26;
	id = "monolith_poddor_west"
	},
/obj/machinery/button/shieldwallgen{
	id = "monolith_shield_west";
	pixel_x = 5;
	pixel_y = 24
	},
/turf/open/floor/plating,
/area/ship/hallway/central)
"ni" = (
/obj/machinery/door/airlock/engineering{
	dir = 4
	},
/obj/structure/cable{
	icon_state = "4-8"
	},
/turf/open/floor/plating,
/area/ship/engineering)
"nU" = (
/obj/structure/table/reinforced/titaniumglass,
/obj/structure/cable{
	icon_state = "1-2"
	},
/turf/open/floor/plasteel/dark,
/area/ship/bridge)
"oa" = (
/obj/structure/cable{
	icon_state = "4-8"
	},
/obj/structure/cable{
	icon_state = "2-4";
	tag = null
	},
/turf/open/floor/plating,
/area/ship/engineering/electrical)
"of" = (
/obj/effect/turf_decal/corner/opaque/ntbluelight/full,
/obj/effect/turf_decal/corner/opaque/white/half{
	dir = 4
	},
/obj/structure/cable{
	icon_state = "4-8"
	},
/turf/open/floor/plasteel/dark,
/area/ship/bridge)
"oD" = (
/obj/effect/landmark/observer_start,
/obj/structure/cable{
	icon_state = "2-8"
	},
/obj/structure/cable{
	icon_state = "2-4"
	},
/obj/structure/cable{
	icon_state = "1-2"
	},
/turf/open/floor/plasteel/dark,
/area/ship/bridge)
"pM" = (
/obj/machinery/door/poddoor{
	id = "monolith_poddor_west";
	dir = 8
	},
/obj/machinery/power/shieldwallgen/atmos/roundstart{
	id = "monolith_shield_west"
	},
/obj/structure/cable{
	d2 = 2;
	icon_state = "0-2"
	},
/turf/open/floor/plasteel/tech,
/area/ship/hallway/central)
"pR" = (
/obj/effect/turf_decal/corner/opaque/ntbluelight{
	dir = 1
	},
/turf/open/floor/plasteel/dark,
/area/ship/bridge)
"qu" = (
/obj/machinery/button/door{
	pixel_x = -4;
	pixel_y = 26;
	id = "monolith_poddor_east";
	name = "Blastdoor button"
	},
/obj/machinery/button/shieldwallgen{
	id = "monolith_shield_east";
	pixel_x = 5;
	pixel_y = 24
	},
/turf/open/floor/plating,
/area/ship/hallway/central)
"qE" = (
/obj/machinery/power/smes/shuttle/precharged{
	dir = 4;
	charge = 5e+006
	},
/obj/structure/cable{
	icon_state = "0-8"
	},
/obj/structure/window/reinforced/spawner/west,
/obj/structure/window/reinforced/spawner,
/obj/machinery/door/poddoor/shutters{
	dir = 4;
	id = "monolith_thr"
	},
/turf/open/floor/plating,
/area/ship/engineering/engines)
"qH" = (
/obj/effect/turf_decal/corner/opaque/ntbluelight{
	dir = 4
	},
/obj/structure/cable{
	icon_state = "1-4"
	},
/turf/open/floor/plasteel/dark,
/area/ship/bridge)
"qQ" = (
/obj/effect/turf_decal/corner/opaque/ntbluelight{
	dir = 8
	},
/turf/closed/wall/mineral/titanium/exterior,
/area/ship/bridge)
"rk" = (
/obj/machinery/light/directional/east,
/turf/open/floor/plating,
/area/ship/engineering)
"rU" = (
/turf/open/floor/plasteel/stairs,
/area/ship/cargo)
"sr" = (
/obj/machinery/mech_bay_recharge_port{
	dir = 8
	},
/turf/open/floor/plasteel/lightgrey,
/area/ship/cargo)
"sy" = (
/obj/machinery/computer/crew{
	dir = 4
	},
/obj/machinery/light/floor,
/turf/open/floor/plasteel/dark,
/area/ship/bridge)
"sz" = (
/obj/structure/cable{
	icon_state = "1-2"
	},
/obj/structure/cable{
	icon_state = "1-8"
	},
/obj/machinery/button/door{
	pixel_x = 26;
	id = "monolith_thr";
	dir = 8;
	pixel_y = 4
	},
/turf/open/floor/plating,
/area/ship/engineering/engines)
"sX" = (
/turf/open/floor/concrete/reinforced,
/area/ship/cargo)
"tc" = (
/obj/machinery/door/airlock/command/glass{
	dir = 4
	},
/obj/effect/turf_decal/corner/opaque/ntbluelight/full,
/turf/open/floor/plasteel/dark,
/area/ship/bridge)
"to" = (
/obj/machinery/door/poddoor{
	id = "monolith_poddor_south"
	},
/obj/docking_port/mobile{
	callTime = 250;
	launch_status = 0;
	name = "Nanotrasen Ship";
	dir = 2
	},
/obj/structure/cable{
	icon_state = "1-8"
	},
/obj/structure/cable{
	icon_state = "1-4"
	},
/turf/open/floor/plasteel/tech,
/area/ship/hallway/central)
"ub" = (
/obj/effect/turf_decal/corner/opaque/ntbluelight/full,
/obj/effect/turf_decal/corner/opaque/white,
/turf/open/floor/plasteel/dark,
/area/ship/bridge)
"uc" = (
/obj/structure/cable{
	icon_state = "4-8"
	},
/turf/open/floor/plasteel/dark,
/area/ship/bridge)
"ue" = (
/obj/effect/turf_decal/corner/opaque/ntbluelight/three_quarters{
	dir = 4
	},
/turf/open/floor/plasteel/dark,
/area/ship/bridge)
"uG" = (
/obj/effect/turf_decal/corner/opaque/ntbluelight/full,
/obj/machinery/door/airlock/command/glass,
/obj/structure/cable{
	icon_state = "1-2"
	},
/turf/open/floor/plasteel/dark,
/area/ship/bridge)
"vd" = (
/turf/open/floor/plasteel/lightgrey,
/area/ship/hallway/central)
"vo" = (
/turf/closed/wall/mineral/titanium/exterior,
/area/ship/crew/canteen)
"vC" = (
/turf/closed/wall/mineral/titanium/exterior,
/area/ship/science)
"vE" = (
/obj/machinery/button/door{
	dir = 8;
	pixel_x = 26;
	pixel_y = 4;
	id = "monolith_poddor_cargo"
	},
/obj/machinery/button/shieldwallgen{
	dir = 8;
	id = "monolith_shield_cargo";
	pixel_x = 24;
	pixel_y = -5
	},
/turf/open/floor/plasteel/lightgrey,
/area/ship/cargo)
"vU" = (
/obj/structure/cable{
	icon_state = "2-4";
	tag = null
	},
/turf/open/floor/plating,
/area/ship/engineering)
"xu" = (
/obj/machinery/door/airlock/engineering/glass{
	dir = 1
	},
/turf/open/floor/plating,
/area/ship/engineering/engines)
"xN" = (
/obj/machinery/button/door{
	dir = 4;
	pixel_x = -26;
	pixel_y = 4;
	id = "monolith_poddor_south"
	},
/obj/machinery/button/shieldwallgen{
	dir = 4;
	id = "monolith_shield_south";
	pixel_x = -24;
	pixel_y = -5
	},
/turf/open/floor/plasteel/lightgrey,
/area/ship/hallway/central)
"xW" = (
/obj/machinery/power/smes/shuttle/precharged{
	dir = 4;
	charge = 5e+006
	},
/obj/structure/cable{
	icon_state = "0-8"
	},
/obj/structure/window/reinforced/spawner/west,
/obj/structure/window/reinforced/spawner/north,
/obj/structure/window/reinforced/spawner,
/obj/machinery/door/poddoor/shutters{
	dir = 4;
	id = "monolith_thr"
	},
/turf/open/floor/plating,
/area/ship/engineering/engines)
"ye" = (
/obj/machinery/door/poddoor{
	id = "monolith_poddor_east";
	dir = 4
	},
/obj/machinery/power/shieldwallgen/atmos/roundstart{
	dir = 1;
	id = "monolith_shield_east"
	},
/obj/structure/cable{
	icon_state = "0-1"
	},
/turf/open/floor/plasteel/tech,
/area/ship/hallway/central)
"yn" = (
/obj/machinery/computer/cargo{
	dir = 8
	},
/obj/machinery/light/floor,
/turf/open/floor/plasteel/dark,
/area/ship/bridge)
"yZ" = (
/obj/machinery/door/poddoor{
	id = "monolith_poddor_east";
	dir = 4
	},
/obj/machinery/power/shieldwallgen/atmos/roundstart{
	id = "monolith_shield_east"
	},
/obj/structure/cable{
	icon_state = "0-2"
	},
/turf/open/floor/plasteel/tech,
/area/ship/hallway/central)
"zJ" = (
/obj/machinery/door/airlock/engineering/glass{
	dir = 1
	},
/obj/structure/cable{
	icon_state = "1-2"
	},
/turf/open/floor/plating,
/area/ship/engineering/engines)
"AN" = (
/obj/effect/turf_decal/corner/opaque/ntbluelight,
/turf/open/floor/plasteel/dark,
/area/ship/bridge)
"Cd" = (
/obj/effect/turf_decal/corner/opaque/ntbluelight/full,
/obj/structure/cable{
	icon_state = "4-8"
	},
/turf/open/floor/plasteel/dark,
/area/ship/bridge)
"Cp" = (
/obj/docking_port/stationary{
	dir = 2
	},
/turf/template_noop,
/area/template_noop)
"Cy" = (
/obj/structure/cable{
	icon_state = "1-2"
	},
/turf/open/floor/plating,
/area/ship/engineering)
"CN" = (
/obj/structure/sign/flag/nanotrasen/directional/west,
/turf/open/floor/plasteel/lightgrey,
/area/ship/hallway/central)
"Dw" = (
/obj/structure/cable{
	icon_state = "1-2"
	},
/obj/structure/cable{
	icon_state = "1-8"
	},
/obj/machinery/light/directional/east,
/turf/open/floor/plating,
/area/ship/engineering/engines)
"DD" = (
/obj/structure/railing{
	dir = 6
	},
/turf/open/floor/concrete/reinforced,
/area/ship/cargo)
"EQ" = (
/obj/machinery/power/shuttle/engine/electric/premium,
/obj/structure/cable{
	icon_state = "0-4"
	},
/turf/open/floor/plating,
/area/ship/engineering/engines)
"ES" = (
/obj/effect/turf_decal/corner/opaque/ntbluelight/three_quarters{
	dir = 8
	},
/obj/machinery/light/directional/east,
/turf/open/floor/plasteel/dark,
/area/ship/bridge)
"Fs" = (
/obj/machinery/door/airlock/engineering{
	dir = 4
	},
/turf/open/floor/plating,
/area/ship/engineering)
"FA" = (
/obj/machinery/door/poddoor{
	id = "monolith_poddor_cargo";
	dir = 8
	},
/turf/open/floor/plating,
/area/ship/cargo)
"FY" = (
/obj/effect/turf_decal/corner/opaque/ntbluelight/full,
/obj/structure/cable{
	icon_state = "2-4";
	tag = null
	},
/turf/open/floor/plasteel/dark,
/area/ship/bridge)
"Gg" = (
/obj/machinery/button/door{
	dir = 8;
	pixel_x = 26;
	pixel_y = 4;
	id = "monolith_poddor_north"
	},
/obj/machinery/button/shieldwallgen{
	dir = 8;
	id = "monolith_shield_north";
	pixel_x = 24;
	pixel_y = -5
	},
/turf/open/floor/plasteel/lightgrey,
/area/ship/hallway/central)
"Gv" = (
/obj/machinery/door/airlock/command/glass{
	dir = 4
	},
/obj/effect/turf_decal/corner/opaque/ntbluelight/full,
/obj/structure/cable{
	icon_state = "4-8"
	},
/turf/open/floor/plasteel/dark,
/area/ship/bridge)
"Gy" = (
/obj/machinery/door/airlock/engineering,
/turf/open/floor/plating,
/area/ship/engineering)
"GS" = (
/obj/effect/turf_decal/corner/opaque/ntbluelight/full,
/turf/open/floor/plasteel/dark,
/area/ship/bridge)
"GY" = (
/obj/machinery/power/smes/engineering{
	charge = 1e+006
	},
/obj/structure/cable{
	icon_state = "0-4"
	},
/turf/open/floor/plating,
/area/ship/engineering/electrical)
"Hd" = (
/turf/closed/wall/mineral/titanium/exterior,
/area/ship/engineering/engines)
"Hg" = (
/obj/structure/railing{
	dir = 10
	},
/turf/open/floor/concrete/reinforced,
/area/ship/cargo)
"Hn" = (
/turf/open/floor/plasteel/stairs{
	dir = 1
	},
/area/ship/cargo)
"Ik" = (
/turf/open/floor/plating,
/area/ship/crew/canteen)
"IZ" = (
/obj/structure/cable{
	icon_state = "2-8"
	},
/obj/structure/cable{
	icon_state = "1-2"
	},
/turf/open/floor/plating,
/area/ship/engineering/electrical)
"Ja" = (
/obj/machinery/door/airlock/command/glass{
	dir = 8
	},
/obj/effect/turf_decal/corner/opaque/ntbluelight/full,
/turf/open/floor/plasteel/dark,
/area/ship/bridge)
"Jk" = (
/turf/open/floor/plating,
/area/ship/engineering)
"JG" = (
/obj/item/stack/sheet/mineral/uranium/twenty,
/obj/structure/closet/crate/radiation,
/turf/open/floor/plating,
/area/ship/engineering/electrical)
"JP" = (
/turf/open/floor/plasteel/lightgrey,
/area/ship/cargo)
"Ka" = (
/obj/machinery/door/poddoor{
	id = "monolith_poddor_east";
	dir = 4
	},
/obj/structure/cable{
	icon_state = "1-8"
	},
/obj/structure/cable{
	icon_state = "2-8"
	},
/turf/open/floor/plasteel/tech,
/area/ship/hallway/central)
"Kp" = (
/obj/effect/turf_decal/corner/opaque/ntbluelight/full,
/obj/structure/cable{
	icon_state = "1-2"
	},
/turf/open/floor/plasteel/dark,
/area/ship/bridge)
"Kt" = (
/obj/effect/turf_decal/corner/opaque/ntbluelight/three_quarters{
	dir = 1
	},
/turf/open/floor/plasteel/dark,
/area/ship/bridge)
"KD" = (
/obj/machinery/door/airlock/mining{
	dir = 8;
	name = "cargo airlock"
	},
/turf/open/floor/plating,
/area/ship/cargo)
"Lf" = (
/obj/machinery/power/smes/engineering{
	charge = 1e+006
	},
/obj/structure/cable{
	icon_state = "0-4"
	},
/obj/machinery/light/directional/west,
/turf/open/floor/plating,
/area/ship/engineering/electrical)
"Lz" = (
/turf/open/floor/plating,
/area/ship/science)
"LS" = (
/obj/structure/window/reinforced/fulltile,
/obj/machinery/door/poddoor/shutters{
	id = "bridge";
	dir = 1
	},
/turf/open/floor/plating,
/area/ship/bridge)
"MN" = (
/obj/structure/railing{
	dir = 9
	},
/turf/open/floor/concrete/reinforced,
/area/ship/cargo)
"MP" = (
/obj/effect/turf_decal/corner/opaque/ntbluelight/full,
/obj/structure/cable{
	icon_state = "4-8"
	},
/obj/structure/cable{
	icon_state = "4-8"
	},
/turf/open/floor/plasteel/dark,
/area/ship/bridge)
"MV" = (
/obj/effect/turf_decal/corner/opaque/ntbluelight/three_quarters,
/turf/open/floor/plasteel/dark,
/area/ship/bridge)
"NJ" = (
/obj/item/banner/nanotrasen,
/turf/open/floor/plating,
/area/ship/hallway/central)
"NS" = (
/obj/effect/turf_decal/corner/opaque/ntbluelight/three_quarters,
/obj/machinery/light/directional/east,
/turf/open/floor/plasteel/dark,
/area/ship/bridge)
"OK" = (
/obj/effect/turf_decal/corner/opaque/ntbluelight/full,
/obj/effect/turf_decal/corner/opaque/white{
	dir = 1
	},
/turf/open/floor/plasteel/dark,
/area/ship/bridge)
"OM" = (
/obj/effect/turf_decal/corner/opaque/ntbluelight/full,
/obj/effect/turf_decal/corner/opaque/white/half{
	dir = 8
	},
/turf/open/floor/plasteel/dark,
/area/ship/bridge)
"PI" = (
/obj/machinery/door/airlock/command/glass{
	dir = 1
	},
/obj/effect/turf_decal/corner/opaque/ntbluelight/full,
/obj/structure/cable{
	icon_state = "1-2"
	},
/turf/open/floor/plasteel/dark,
/area/ship/bridge)
"Qs" = (
/obj/machinery/door/poddoor{
	id = "monolith_poddor_west";
	dir = 8
	},
/obj/structure/cable{
	icon_state = "2-4";
	tag = null
	},
/obj/structure/cable{
	icon_state = "1-4"
	},
/turf/open/floor/plasteel/tech,
/area/ship/hallway/central)
"QX" = (
/obj/structure/cable{
	icon_state = "1-2"
	},
/obj/structure/cable{
	icon_state = "1-2"
	},
/turf/open/floor/plasteel/lightgrey,
/area/ship/hallway/central)
"Rm" = (
/obj/structure/cable{
	icon_state = "1-8"
	},
/obj/structure/cable{
	icon_state = "2-8"
	},
/turf/open/floor/plasteel/lightgrey,
/area/ship/hallway/central)
"Ry" = (
/obj/structure/cable{
	icon_state = "4-8"
	},
/turf/open/floor/plating,
/area/ship/engineering/electrical)
"RE" = (
/obj/effect/turf_decal/corner/opaque/ntbluelight{
	dir = 1
	},
/turf/closed/wall/mineral/titanium/exterior,
/area/ship/bridge)
"RH" = (
/obj/structure/cable{
	icon_state = "2-8"
	},
/turf/open/floor/plating,
/area/ship/engineering)
"Sj" = (
/obj/structure/cable{
	icon_state = "2-4";
	tag = null
	},
/obj/structure/cable{
	icon_state = "2-8"
	},
/obj/machinery/door/poddoor{
	id = "monolith_poddor_north"
	},
/turf/open/floor/plasteel/tech,
/area/ship/hallway/central)
"Sx" = (
/turf/open/floor/plasteel/darkyellowfull/darkyellow,
/area/ship/hallway/central)
"TF" = (
/obj/machinery/power/smes/shuttle/precharged{
	dir = 4;
	charge = 5e+006
	},
/obj/structure/window/reinforced/spawner/west,
/obj/structure/window/reinforced/spawner/north,
/obj/structure/window/reinforced/spawner,
/obj/structure/cable{
	icon_state = "0-8"
	},
/obj/machinery/door/poddoor/shutters{
	dir = 4;
	id = "monolith_thr"
	},
/turf/open/floor/plating,
/area/ship/engineering/engines)
"TM" = (
/obj/effect/turf_decal/corner/opaque/ntbluelight/bordercorner{
	dir = 8
	},
/turf/open/floor/plasteel/dark,
/area/ship/bridge)
"UL" = (
/turf/template_noop,
/area/template_noop)
"VA" = (
/obj/structure/cable{
	icon_state = "1-8"
	},
/turf/open/floor/plating,
/area/ship/engineering/electrical)
"Wd" = (
/turf/open/floor/plating,
/area/ship/hallway/central)
"Wn" = (
/obj/item/banner/nanotrasen,
/turf/open/floor/plasteel/darkyellowfull/darkyellow,
/area/ship/hallway/central)
"WK" = (
/obj/machinery/door/poddoor{
	id = "monolith_poddor_east";
	dir = 4
	},
/obj/structure/cable{
	icon_state = "1-2"
	},
/turf/open/floor/plasteel/tech,
/area/ship/hallway/central)
"WW" = (
/obj/structure/cable{
	icon_state = "1-2"
	},
/turf/open/floor/plasteel/lightgrey,
/area/ship/hallway/central)
"XC" = (
/obj/effect/turf_decal/corner/opaque/ntbluelight/full,
/obj/effect/turf_decal/corner/opaque/white/half{
	dir = 1
	},
/turf/open/floor/plasteel/dark,
/area/ship/bridge)
"XO" = (
/obj/machinery/power/shieldwallgen/atmos/roundstart{
	dir = 8;
	id = "monolith_shield_north"
	},
/obj/structure/cable{
	icon_state = "0-8"
	},
/obj/machinery/door/poddoor{
	id = "monolith_poddor_north"
	},
/turf/open/floor/plasteel/tech,
/area/ship/hallway/central)
"XR" = (
/obj/machinery/power/shieldwallgen/atmos/roundstart{
	dir = 4;
	id = "monolith_shield_south"
	},
/obj/machinery/door/poddoor{
	id = "monolith_poddor_south"
	},
/obj/structure/cable{
	icon_state = "0-4"
	},
/turf/open/floor/plasteel/tech,
/area/ship/hallway/central)
"XU" = (
/obj/structure/cable{
	icon_state = "4-8"
	},
/turf/open/floor/plasteel/lightgrey,
/area/ship/hallway/central)
"YN" = (
/obj/effect/turf_decal/rechargefloor,
/obj/mecha/working/ripley/nanotrasen,
/turf/open/floor/plasteel/lightgrey,
/area/ship/cargo)
"Zc" = (
/obj/structure/chair/comfy/shuttle{
	name = "helm shuttle chair";
	dir = 1
	},
/obj/structure/cable{
	icon_state = "1-2"
	},
/turf/open/floor/plasteel/dark,
/area/ship/bridge)
"ZD" = (
/obj/effect/turf_decal/corner/opaque/ntbluelight{
	dir = 4
	},
/turf/closed/wall/mineral/titanium/exterior,
/area/ship/bridge)
"ZT" = (
/obj/machinery/door/airlock/engineering/glass,
/turf/open/floor/plating,
/area/ship/engineering/engines)

(1,1,1) = {"
UL
UL
UL
UL
UL
UL
UL
UL
UL
UL
UL
UL
UL
UL
UL
UL
UL
UL
UL
UL
UL
UL
UL
UL
UL
UL
UL
UL
UL
UL
UL
UL
UL
UL
UL
UL
UL
"}
(2,1,1) = {"
UL
vo
vo
vo
vo
vo
vo
vo
vo
vo
vo
vo
vo
vo
vo
vo
pM
kr
Qs
dO
iI
iI
iI
Hd
EQ
EQ
EQ
EQ
EQ
EQ
EQ
EQ
Hd
iI
iI
iI
UL
"}
(3,1,1) = {"
UL
vo
Ik
Ik
Ik
Ik
Ik
Ik
Ik
Ik
Ik
Ik
Ik
Ik
Ik
vo
Wd
vd
XU
Sx
iI
Jk
Jk
Hd
qE
xW
xW
xW
xW
xW
xW
TF
Hd
Jk
Jk
iI
UL
"}
(4,1,1) = {"
UL
vo
Ik
Ik
Ik
Ik
Ik
Ik
Ik
Ik
Ik
Ik
Ik
Ik
Ik
vo
mO
vd
XU
Sx
iI
Jk
Jk
xu
iX
iX
iX
iX
iX
iX
iX
iX
ZT
Jk
Jk
iI
UL
"}
(5,1,1) = {"
UL
vo
Ik
Ik
Ik
Ik
Ik
Ik
Ik
Ik
Ik
Ik
Ik
Ik
Ik
vo
Wd
vd
XU
Sx
iI
Jk
vU
zJ
di
Dw
di
di
sz
Dw
di
bW
ZT
Jk
Jk
iI
UL
"}
(6,1,1) = {"
UL
vo
Ik
Ik
Ik
Ik
Ik
Ik
Ik
Ik
Ik
Ik
Ik
Ik
Ik
vo
Wd
vd
XU
Sx
iI
Jk
hd
Hd
Hd
Hd
Hd
Hd
Hd
Hd
Hd
Hd
Hd
Jk
Jk
iI
UL
"}
(7,1,1) = {"
UL
vo
Ik
Ik
Ik
Ik
Ik
Ik
Ik
Ik
Ik
Ik
Ik
Ik
Ik
vo
Wd
vd
XU
Sx
iI
Jk
hd
hZ
dl
JG
aT
aT
Lf
GY
eS
Jk
Jk
Jk
Jk
iI
UL
"}
(8,1,1) = {"
UL
vo
Ik
Ik
Ik
Ik
Ik
Ik
Ik
Ik
Ik
Ik
Ik
Ik
Ik
vo
Wd
vd
XU
Sx
Gy
Jk
hd
Jk
dl
dl
fv
IZ
mB
la
Ry
Jk
Jk
Jk
Jk
iI
UL
"}
(9,1,1) = {"
UL
vo
Ik
Ik
Ik
Ik
Ik
Ik
Ik
Ik
Ik
Ik
Ik
Ik
Ik
vo
Wd
vd
XU
Sx
Gy
Jk
hd
Jk
dl
dl
dl
dl
oa
VA
Ry
Jk
Jk
Jk
Jk
iI
UL
"}
(10,1,1) = {"
UL
vo
Ik
Ik
Ik
Ik
Ik
Ik
Ik
Ik
Ik
Ik
Ik
Ik
Ik
vo
Wd
vd
XU
Sx
iI
Jk
hd
Jk
dl
dl
dl
dl
Ry
dl
Ry
Jk
Jk
Jk
Jk
iI
UL
"}
(11,1,1) = {"
UL
vo
Ik
Ik
Ik
Ik
Ik
Ik
Ik
Ik
Ik
Ik
Ik
Ik
Ik
vo
Wd
vd
XU
Sx
iI
Jk
RH
Cy
Cy
Cy
Cy
Cy
aU
Cy
ga
Jk
Jk
Jk
Jk
iI
UL
"}
(12,1,1) = {"
UL
vo
Ik
Ik
Ik
Ik
Ik
Ik
Ik
Ik
Ik
Ik
Ik
Ik
Ik
vo
Wd
vd
XU
Sx
iI
Jk
Jk
Jk
Jk
Jk
Jk
Jk
hd
Jk
Jk
Jk
Jk
Jk
Jk
iI
UL
"}
(13,1,1) = {"
UL
vo
Ik
Ik
Ik
Ik
Ik
Ik
Ik
Ik
Ik
Ik
Ik
Ik
Ik
vo
NJ
vd
XU
Wn
iI
Jk
Jk
Jk
Jk
Jk
Jk
Jk
hd
Jk
Jk
Jk
Jk
Jk
Jk
iI
UL
"}
(14,1,1) = {"
UL
vo
Ik
Ik
Ik
Ik
Ik
Ik
Ik
Ik
Ik
Ik
Ik
Ik
iA
iA
iA
Ja
kW
iA
iA
iA
Jk
Jk
Jk
Jk
Jk
Jk
hd
Jk
Jk
Jk
Jk
Jk
Jk
iI
UL
"}
(15,1,1) = {"
UL
vo
Ik
Ik
Ik
Ik
Ik
Ik
Ik
Ik
Ik
Ik
Ik
iA
lr
ue
lt
GS
Cd
lt
Kt
ZD
iA
Jk
Jk
Jk
Jk
Jk
hd
Jk
Jk
Jk
Jk
Jk
Jk
iI
UL
"}
(16,1,1) = {"
UL
vo
Ik
Ik
Ik
Ik
Ik
Ik
Ik
Ik
Ik
Ik
iA
lr
ue
fK
AN
GS
fZ
qH
TM
Kt
ZD
iA
Jk
rk
Jk
Jk
hd
Jk
rk
Jk
Jk
Jk
Jk
iI
UL
"}
(17,1,1) = {"
UL
vo
vo
vo
vo
vo
vo
vo
vo
vo
vo
vo
iA
kI
gh
AN
dp
km
ct
Cd
jK
TM
gB
iA
iI
iI
iI
iI
ni
Fs
iI
iI
iI
iI
iI
iI
UL
"}
(18,1,1) = {"
UL
bT
vd
vd
vd
vd
vd
vd
vd
vd
vd
iT
LS
ub
of
XC
ct
yn
ct
uc
GS
GS
GS
gP
iT
vd
vd
vd
XU
vd
vd
vd
vd
xN
vd
XR
UL
"}
(19,1,1) = {"
UL
Sj
WW
WW
WW
WW
WW
WW
WW
WW
WW
QX
PI
Kp
gJ
Kp
nU
fH
Zc
oD
Kp
Kp
Kp
uG
WW
WW
WW
WW
Rm
WW
WW
WW
WW
WW
WW
to
Cp
"}
(20,1,1) = {"
UL
XO
vd
Gg
vd
vd
vd
vd
vd
vd
vd
CN
LS
hE
OM
OK
ct
sy
ct
uc
GS
GS
GS
gP
CN
vd
vd
vd
vd
vd
vd
vd
vd
vd
vd
hL
UL
"}
(21,1,1) = {"
UL
vC
vC
vC
vC
vC
vC
vC
vC
vC
vC
vC
iA
ES
hC
aR
dp
dH
be
MP
pR
bX
NS
iA
fu
fu
fu
fu
KD
KD
fu
fu
fu
fu
fu
fu
UL
"}
(22,1,1) = {"
UL
vC
Lz
Lz
Lz
Lz
Lz
Lz
Lz
Lz
Lz
Lz
iA
qQ
bo
hC
aR
GS
FY
dR
bX
MV
RE
iA
eG
eG
eG
eG
eG
eG
eG
eG
eG
eG
eG
fu
UL
"}
(23,1,1) = {"
UL
vC
Lz
Lz
Lz
Lz
Lz
Lz
Lz
Lz
Lz
Lz
Lz
iA
qQ
if
jP
GS
Cd
jP
MV
RE
iA
eG
eG
eG
eG
eG
eG
eG
eG
eG
eG
eG
eG
fu
UL
"}
(24,1,1) = {"
UL
vC
Lz
Lz
Lz
Lz
Lz
Lz
Lz
Lz
Lz
Lz
Lz
Lz
iA
iA
iA
tc
Gv
iA
iA
iA
eG
eG
eG
eG
eG
eG
eG
eG
eG
eG
eG
eG
eG
fu
UL
"}
(25,1,1) = {"
UL
vC
Lz
Lz
Lz
Lz
Lz
Lz
Lz
Lz
Lz
Lz
Lz
Lz
Lz
vC
NJ
vd
XU
NJ
fu
eG
eG
eG
eG
eG
eG
eG
eG
eG
eG
eG
eG
eG
eG
fu
UL
"}
(26,1,1) = {"
UL
vC
Lz
Lz
Lz
Lz
Lz
Lz
Lz
Lz
Lz
Lz
Lz
Lz
Lz
vC
Wd
vd
XU
Wd
fu
eG
eG
eG
eG
eG
eG
eG
eG
eG
eG
eG
eG
eG
eG
fu
UL
"}
(27,1,1) = {"
UL
vC
Lz
Lz
Lz
Lz
Lz
Lz
Lz
Lz
Lz
Lz
Lz
Lz
Lz
vC
Wd
vd
XU
Wd
fu
JP
JP
JP
JP
bL
sX
sX
sX
sX
lR
JP
JP
JP
JP
fu
UL
"}
(28,1,1) = {"
UL
vC
Lz
Lz
Lz
Lz
Lz
Lz
Lz
Lz
Lz
Lz
Lz
Lz
Lz
vC
Wd
vd
XU
Wd
fu
JP
JP
JP
JP
bL
sX
sX
sX
sX
lR
JP
JP
JP
JP
fu
UL
"}
(29,1,1) = {"
UL
vC
Lz
Lz
Lz
Lz
Lz
Lz
Lz
Lz
Lz
Lz
Lz
Lz
Lz
vC
Wd
vd
XU
Wd
id
JP
JP
JP
JP
bL
sX
sX
sX
sX
lR
JP
JP
JP
JP
fu
UL
"}
(30,1,1) = {"
UL
vC
Lz
Lz
Lz
Lz
Lz
Lz
Lz
Lz
Lz
Lz
Lz
Lz
Lz
vC
Wd
vd
XU
Wd
id
JP
JP
JP
JP
bL
sX
sX
sX
sX
lR
JP
JP
JP
JP
fu
UL
"}
(31,1,1) = {"
UL
vC
Lz
Lz
Lz
Lz
Lz
Lz
Lz
Lz
Lz
Lz
Lz
Lz
Lz
vC
Wd
vd
XU
Wd
fu
JP
JP
JP
JP
lm
sX
sX
sX
sX
DD
JP
JP
JP
JP
fu
UL
"}
(32,1,1) = {"
UL
vC
Lz
Lz
Lz
Lz
Lz
Lz
Lz
Lz
Lz
Lz
Lz
Lz
Lz
vC
Wd
vd
XU
Wd
fu
JP
JP
JP
JP
rU
sX
sX
sX
sX
Hn
JP
JP
JP
JP
fu
UL
"}
(33,1,1) = {"
UL
vC
Lz
Lz
Lz
Lz
Lz
Lz
Lz
Lz
Lz
Lz
Lz
Lz
Lz
vC
Wd
vd
XU
Wd
fu
YN
JP
JP
JP
rU
sX
sX
sX
sX
Hn
JP
JP
JP
JP
fu
UL
"}
(34,1,1) = {"
UL
vC
Lz
Lz
Lz
Lz
Lz
Lz
Lz
Lz
Lz
Lz
Lz
Lz
Lz
vC
qu
vd
XU
Wd
fu
sr
JP
JP
JP
MN
sX
sX
sX
sX
Hg
JP
JP
JP
JP
fu
UL
"}
(35,1,1) = {"
UL
vC
Lz
Lz
Lz
Lz
Lz
Lz
Lz
Lz
Lz
Lz
Lz
Lz
Lz
vC
Wd
vd
XU
Wd
fu
jo
JP
JP
JP
bL
sX
sX
sX
sX
lR
vE
JP
JP
JP
fu
UL
"}
(36,1,1) = {"
UL
vC
vC
vC
vC
vC
vC
vC
vC
vC
vC
vC
vC
vC
vC
vC
yZ
WK
Ka
ye
fu
fu
fu
fu
fu
FA
FA
FA
FA
FA
FA
fu
fu
fu
fu
fu
UL
"}
(37,1,1) = {"
UL
UL
UL
UL
UL
UL
UL
UL
UL
UL
UL
UL
UL
UL
UL
UL
UL
UL
UL
UL
UL
UL
UL
UL
UL
UL
UL
UL
UL
UL
UL
UL
UL
UL
UL
UL
UL
"}
