//MAP CONVERTED BY dmm2tgm.py THIS HEADER COMMENT PREVENTS RECONVERSION, DO NOT REMOVE
"aR" = (
/obj/effect/turf_decal/corner/opaque/ntbluelight{
	dir = 8
	},
/turf/open/floor/plasteel/dark,
/area/ship/bridge)
"be" = (
/turf/open/floor/plasteel/dark,
/area/ship/bridge)
"bo" = (
/obj/effect/turf_decal/corner/opaque/ntbluelight/three_quarters{
	dir = 8
	},
/turf/open/floor/plasteel/dark,
/area/ship/bridge)
"bT" = (
/obj/machinery/power/shieldwallgen/atmos/roundstart{
	dir = 4;
	id = "monolith_shield_north"
	},
/obj/machinery/door/poddoor{
	id = "monolith_poddor_north"
	},
/turf/open/floor/plasteel/dark_2,
/area/ship/hallway/central)
"bX" = (
/obj/effect/turf_decal/corner/opaque/ntbluelight/bordercorner,
/turf/open/floor/plasteel/dark,
/area/ship/bridge)
"ct" = (
/obj/structure/table/reinforced/titaniumglass,
/turf/open/floor/plasteel/dark,
/area/ship/bridge)
"dl" = (
/obj/machinery/atmospherics/components/binary/circulator,
/turf/open/floor/plating,
/area/ship/engineering)
"dp" = (
/obj/structure/table/reinforced/titaniumglass,
/obj/effect/turf_decal/corner/opaque/ntbluelight/full,
/turf/open/floor/plasteel/dark,
/area/ship/bridge)
"dH" = (
/obj/structure/chair/comfy/shuttle{
	name = "helm shuttle chair";
	dir = 8
	},
/turf/open/floor/plasteel/dark,
/area/ship/bridge)
"dR" = (
/obj/mecha/working/ripley/nanotrasen,
/turf/open/floor/plating,
/area/ship/cargo)
"eG" = (
/turf/open/floor/plating,
/area/ship/cargo)
"fu" = (
/turf/closed/wall/mineral/titanium/exterior,
/area/ship/cargo)
"fH" = (
/obj/machinery/computer/helm,
/turf/open/floor/plasteel/dark,
/area/ship/bridge)
"fK" = (
/obj/effect/turf_decal/corner/opaque/ntbluelight/bordercorner{
	dir = 1
	},
/turf/open/floor/plasteel/dark,
/area/ship/bridge)
"ga" = (
/obj/machinery/power/generator{
	dir = 4
	},
/turf/open/floor/plating,
/area/ship/engineering)
"gJ" = (
/obj/effect/turf_decal/corner/opaque/ntbluelight/full,
/obj/effect/turf_decal/corner/opaque/white/diagonal,
/turf/open/floor/plasteel/dark,
/area/ship/bridge)
"gP" = (
/obj/structure/window/reinforced/fulltile,
/turf/open/floor/plating,
/area/ship/bridge)
"hC" = (
/obj/effect/turf_decal/corner/opaque/ntbluelight/bordercorner{
	dir = 4
	},
/turf/open/floor/plasteel/dark,
/area/ship/bridge)
"hE" = (
/obj/effect/turf_decal/corner/opaque/ntbluelight/full,
/obj/effect/turf_decal/corner/opaque/white/half,
/turf/open/floor/plasteel/dark,
/area/ship/bridge)
"hL" = (
/obj/machinery/power/shieldwallgen/atmos/roundstart{
	dir = 8;
	id = "monolith_shield_south"
	},
/obj/machinery/door/poddoor{
	id = "monolith_poddor_south"
	},
/turf/open/floor/plasteel/dark_2,
/area/ship/hallway/central)
"if" = (
/obj/effect/turf_decal/corner/opaque/ntbluelight/three_quarters{
	dir = 8
	},
/obj/machinery/cryopod{
	dir = 8
	},
/obj/machinery/computer/cryopod/directional{
	dir = 1;
	pixel_y = 26
	},
/turf/open/floor/plasteel/dark,
/area/ship/bridge)
"iA" = (
/turf/closed/wall/mineral/titanium/exterior,
/area/ship/bridge)
"iI" = (
/turf/closed/wall/mineral/titanium/exterior,
/area/ship/engineering)
"iT" = (
/obj/structure/sign/flag/nanotrasen/directional/east,
/turf/open/floor/plasteel/lightgrey,
/area/ship/hallway/central)
"iX" = (
/obj/effect/turf_decal/corner/opaque/white/half{
	dir = 1
	},
/turf/open/floor/plasteel/dark,
/area/ship/science)
"jK" = (
/obj/effect/turf_decal/corner/opaque/ntbluelight{
	dir = 4
	},
/turf/open/floor/plasteel/dark,
/area/ship/bridge)
"jP" = (
/obj/effect/turf_decal/corner/opaque/ntbluelight/half{
	dir = 4
	},
/turf/open/floor/plasteel/dark,
/area/ship/bridge)
"km" = (
/obj/structure/chair/comfy/shuttle{
	name = "helm shuttle chair";
	dir = 4
	},
/turf/open/floor/plasteel/dark,
/area/ship/bridge)
"lr" = (
/obj/effect/turf_decal/corner/opaque/ntbluelight,
/turf/closed/wall/mineral/titanium/exterior,
/area/ship/bridge)
"lt" = (
/obj/effect/turf_decal/corner/opaque/ntbluelight/half{
	dir = 8
	},
/turf/open/floor/plasteel/dark,
/area/ship/bridge)
"lR" = (
/obj/structure/table/reinforced/titaniumglass,
/obj/structure/window/reinforced/spawner/west,
/turf/open/floor/plasteel/dark,
/area/ship/bridge)
"oa" = (
/obj/machinery/atmospherics/components/binary/circulator/cold{
	dir = 1
	},
/turf/open/floor/plating,
/area/ship/engineering)
"of" = (
/obj/effect/turf_decal/corner/opaque/ntbluelight/full,
/obj/effect/turf_decal/corner/opaque/white/half{
	dir = 4
	},
/turf/open/floor/plasteel/dark,
/area/ship/bridge)
"oD" = (
/obj/effect/landmark/observer_start,
/obj/machinery/door/window/southleft{
	req_ship_access = 1
	},
/turf/open/floor/plasteel/dark,
/area/ship/bridge)
"pR" = (
/obj/effect/turf_decal/corner/opaque/ntbluelight{
	dir = 1
	},
/turf/open/floor/plasteel/dark,
/area/ship/bridge)
"qE" = (
/obj/effect/turf_decal/corner/opaque/ntbluelight/half{
	dir = 1
	},
/obj/effect/turf_decal/corner/opaque/white/half,
/turf/open/floor/plasteel/dark,
/area/ship/science)
"qQ" = (
/obj/effect/turf_decal/corner/opaque/ntbluelight{
	dir = 8
	},
/turf/closed/wall/mineral/titanium/exterior,
/area/ship/bridge)
"sy" = (
/obj/machinery/computer/crew{
	dir = 4
	},
/turf/open/floor/plasteel/dark,
/area/ship/bridge)
"sX" = (
/obj/structure/window/reinforced/spawner/west,
/obj/structure/table/reinforced/titaniumglass,
/obj/structure/window/reinforced/spawner,
/turf/open/floor/plasteel/dark,
/area/ship/bridge)
"tc" = (
/obj/machinery/door/airlock/command/glass{
	dir = 4
	},
/obj/effect/turf_decal/corner/opaque/ntbluelight/full,
/turf/open/floor/plasteel/dark,
/area/ship/bridge)
"to" = (
/obj/machinery/door/poddoor{
	id = "monolith_poddor_south"
	},
/obj/docking_port/mobile{
	callTime = 250;
	launch_status = 0;
	name = "Nanotrasen Ship";
	dir = 2
	},
/turf/open/floor/plasteel/dark_2,
/area/ship/hallway/central)
"ub" = (
/obj/effect/turf_decal/corner/opaque/ntbluelight/full,
/obj/effect/turf_decal/corner/opaque/white,
/turf/open/floor/plasteel/dark,
/area/ship/bridge)
"uc" = (
/obj/structure/table/reinforced/titaniumglass,
/obj/structure/window/reinforced/spawner/east,
/obj/structure/window/reinforced/spawner,
/turf/open/floor/plasteel/dark,
/area/ship/bridge)
"ue" = (
/obj/effect/turf_decal/corner/opaque/ntbluelight/three_quarters{
	dir = 4
	},
/turf/open/floor/plasteel/dark,
/area/ship/bridge)
"uG" = (
/obj/effect/turf_decal/corner/opaque/ntbluelight/full,
/obj/machinery/door/airlock/command/glass{
	dir = 1
	},
/turf/open/floor/plasteel/dark,
/area/ship/bridge)
"vd" = (
/turf/open/floor/plasteel/lightgrey,
/area/ship/hallway/central)
"vo" = (
/turf/closed/wall/mineral/titanium/exterior,
/area/ship/crew/canteen)
"vC" = (
/turf/closed/wall/mineral/titanium/exterior,
/area/ship/science)
"yn" = (
/obj/machinery/computer/cargo{
	dir = 8
	},
/turf/open/floor/plasteel/dark,
/area/ship/bridge)
"AN" = (
/obj/effect/turf_decal/corner/opaque/ntbluelight,
/turf/open/floor/plasteel/dark,
/area/ship/bridge)
"Cp" = (
/obj/docking_port/stationary{
	dir = 2
	},
/turf/template_noop,
/area/template_noop)
"CN" = (
/obj/structure/sign/flag/nanotrasen/directional/west,
/turf/open/floor/plasteel/lightgrey,
/area/ship/hallway/central)
"EQ" = (
/obj/effect/turf_decal/corner/opaque/ntbluelight/half{
	dir = 1
	},
/turf/open/floor/plasteel/dark,
/area/ship/science)
"Fs" = (
/obj/machinery/door/airlock/engineering{
	dir = 4
	},
/turf/open/floor/plating,
/area/ship/engineering)
"Gg" = (
/obj/machinery/button/door{
	dir = 8;
	pixel_x = 26;
	pixel_y = 3;
	id = "monolith_poddor_north"
	},
/obj/machinery/button/shieldwallgen{
	dir = 8;
	id = "monolith_shield_north";
	pixel_x = 24;
	pixel_y = -5
	},
/turf/open/floor/plasteel/lightgrey,
/area/ship/hallway/central)
"Gy" = (
/obj/machinery/door/airlock/engineering,
/turf/open/floor/plating,
/area/ship/engineering)
"GS" = (
/obj/effect/turf_decal/corner/opaque/ntbluelight/full,
/turf/open/floor/plasteel/dark,
/area/ship/bridge)
"Hd" = (
/obj/effect/turf_decal/corner/opaque/white/half{
	dir = 8
	},
/turf/open/floor/plasteel/dark,
/area/ship/science)
"Hn" = (
/obj/effect/turf_decal/corner/opaque/white/half{
	dir = 4
	},
/turf/open/floor/plasteel/dark,
/area/ship/science)
"Ik" = (
/turf/open/floor/plating,
/area/ship/crew/canteen)
"Jk" = (
/turf/open/floor/plating,
/area/ship/engineering)
"JP" = (
/obj/effect/turf_decal/corner/opaque/white{
	dir = 1
	},
/turf/open/floor/plasteel/dark,
/area/ship/science)
"Kt" = (
/obj/effect/turf_decal/corner/opaque/ntbluelight/three_quarters{
	dir = 1
	},
/turf/open/floor/plasteel/dark,
/area/ship/bridge)
"Lf" = (
/obj/structure/table/reinforced/titaniumglass,
/obj/structure/window/reinforced/spawner/east,
/turf/open/floor/plasteel/dark,
/area/ship/bridge)
"Lz" = (
/turf/open/floor/plating,
/area/ship/science)
"MV" = (
/obj/effect/turf_decal/corner/opaque/ntbluelight/three_quarters,
/turf/open/floor/plasteel/dark,
/area/ship/bridge)
"NJ" = (
/obj/item/banner/nanotrasen,
/turf/open/floor/plating,
/area/ship/hallway/central)
"OK" = (
/obj/effect/turf_decal/corner/opaque/ntbluelight/full,
/obj/effect/turf_decal/corner/opaque/white{
	dir = 1
	},
/turf/open/floor/plasteel/dark,
/area/ship/bridge)
"OM" = (
/obj/effect/turf_decal/corner/opaque/ntbluelight/full,
/obj/effect/turf_decal/corner/opaque/white/half{
	dir = 8
	},
/turf/open/floor/plasteel/dark,
/area/ship/bridge)
"PI" = (
/obj/machinery/door/airlock/command/glass,
/obj/effect/turf_decal/corner/opaque/ntbluelight/full,
/turf/open/floor/plasteel/dark,
/area/ship/bridge)
"Qs" = (
/obj/machinery/button/shieldwallgen{
	dir = 4;
	id = "monolith_shield_south";
	pixel_x = -24;
	pixel_y = -5
	},
/obj/machinery/button/door{
	dir = 4;
	pixel_x = -26;
	pixel_y = 3;
	id = "monolith_poddor_south"
	},
/turf/open/floor/plasteel/lightgrey,
/area/ship/hallway/central)
"RE" = (
/obj/effect/turf_decal/corner/opaque/ntbluelight{
	dir = 1
	},
/turf/closed/wall/mineral/titanium/exterior,
/area/ship/bridge)
"Sj" = (
/obj/machinery/door/poddoor{
	id = "monolith_poddor_north"
	},
/turf/open/floor/plasteel/dark_2,
/area/ship/hallway/central)
"Sx" = (
/turf/open/floor/plasteel/darkyellowfull/darkyellow,
/area/ship/hallway/central)
"TM" = (
/obj/effect/turf_decal/corner/opaque/ntbluelight/bordercorner{
	dir = 8
	},
/turf/open/floor/plasteel/dark,
/area/ship/bridge)
"UL" = (
/turf/template_noop,
/area/template_noop)
"VA" = (
/turf/open/floor/plasteel/dark,
/area/ship/science)
"Wd" = (
/turf/open/floor/plating,
/area/ship/hallway/central)
"Wn" = (
/obj/item/banner/nanotrasen,
/turf/open/floor/plasteel/darkyellowfull/darkyellow,
/area/ship/hallway/central)
"WK" = (
/turf/open/floor/plasteel/dark_2,
/area/ship/hallway/central)
"WW" = (
/obj/effect/turf_decal/corner/opaque/ntbluelight/half{
	dir = 1
	},
/obj/effect/turf_decal/corner/opaque/white,
/turf/open/floor/plasteel/dark,
/area/ship/science)
"XC" = (
/obj/effect/turf_decal/corner/opaque/ntbluelight/full,
/obj/effect/turf_decal/corner/opaque/white/half{
	dir = 1
	},
/turf/open/floor/plasteel/dark,
/area/ship/bridge)
"XO" = (
/obj/machinery/power/shieldwallgen/atmos/roundstart{
	dir = 8;
	id = "monolith_shield_north"
	},
/obj/machinery/door/poddoor{
	id = "monolith_poddor_north"
	},
/turf/open/floor/plasteel/dark_2,
/area/ship/hallway/central)
"XR" = (
/obj/machinery/power/shieldwallgen/atmos/roundstart{
	dir = 4;
	id = "monolith_shield_south"
	},
/obj/machinery/door/poddoor{
	id = "monolith_poddor_south"
	},
/turf/open/floor/plasteel/dark_2,
/area/ship/hallway/central)
"XU" = (
/obj/effect/turf_decal/corner/opaque/white/diagonal,
/turf/open/floor/plasteel/dark,
/area/ship/science)
"Zc" = (
/obj/structure/chair/comfy/shuttle{
	name = "helm shuttle chair";
	dir = 1
	},
/turf/open/floor/plasteel/dark,
/area/ship/bridge)
"ZD" = (
/obj/effect/turf_decal/corner/opaque/ntbluelight{
	dir = 4
	},
/turf/closed/wall/mineral/titanium/exterior,
/area/ship/bridge)

(1,1,1) = {"
UL
UL
UL
UL
UL
UL
UL
UL
UL
UL
UL
UL
UL
UL
UL
UL
UL
UL
UL
UL
UL
UL
UL
UL
UL
UL
UL
UL
UL
UL
UL
UL
UL
UL
UL
UL
UL
"}
(2,1,1) = {"
UL
vo
vo
vo
vo
vo
vo
vo
vo
vo
vo
vo
vo
vo
vo
vo
WK
WK
WK
WK
iI
iI
iI
iI
iI
iI
iI
iI
iI
iI
iI
iI
iI
iI
iI
iI
UL
"}
(3,1,1) = {"
UL
vo
Ik
Ik
Ik
Ik
Ik
Ik
Ik
Ik
Ik
Ik
Ik
Ik
Ik
vo
Wd
vd
vd
Sx
iI
Jk
Jk
Jk
Jk
Jk
Jk
Jk
Jk
Jk
Jk
Jk
Jk
Jk
Jk
iI
UL
"}
(4,1,1) = {"
UL
vo
Ik
Ik
Ik
Ik
Ik
Ik
Ik
Ik
Ik
Ik
Ik
Ik
Ik
vo
Wd
vd
vd
Sx
iI
Jk
Jk
Jk
Jk
Jk
Jk
Jk
Jk
Jk
Jk
Jk
Jk
Jk
Jk
iI
UL
"}
(5,1,1) = {"
UL
vo
Ik
Ik
Ik
Ik
Ik
Ik
Ik
Ik
Ik
Ik
Ik
Ik
Ik
vo
Wd
vd
vd
Sx
iI
Jk
Jk
Jk
Jk
Jk
Jk
Jk
Jk
Jk
Jk
Jk
Jk
Jk
Jk
iI
UL
"}
(6,1,1) = {"
UL
vo
Ik
Ik
Ik
Ik
Ik
Ik
Ik
Ik
Ik
Ik
Ik
Ik
Ik
vo
Wd
vd
vd
Sx
iI
Jk
Jk
Jk
Jk
Jk
Jk
Jk
Jk
Jk
Jk
Jk
Jk
Jk
Jk
iI
UL
"}
(7,1,1) = {"
UL
vo
Ik
Ik
Ik
Ik
Ik
Ik
Ik
Ik
Ik
Ik
Ik
Ik
Ik
vo
Wd
vd
vd
Sx
iI
Jk
Jk
Jk
Jk
Jk
Jk
Jk
Jk
Jk
Jk
Jk
Jk
Jk
Jk
iI
UL
"}
(8,1,1) = {"
UL
vo
Ik
Ik
Ik
Ik
Ik
Ik
Ik
Ik
Ik
Ik
Ik
Ik
Ik
vo
Wd
vd
vd
Sx
Gy
Jk
Jk
Jk
Jk
Jk
Jk
Jk
Jk
Jk
Jk
Jk
Jk
Jk
Jk
iI
UL
"}
(9,1,1) = {"
UL
vo
Ik
Ik
Ik
Ik
Ik
Ik
Ik
Ik
Ik
Ik
Ik
Ik
Ik
vo
Wd
vd
vd
Sx
Gy
Jk
Jk
Jk
Jk
Jk
dl
ga
oa
Jk
Jk
Jk
Jk
Jk
Jk
iI
UL
"}
(10,1,1) = {"
UL
vo
Ik
Ik
Ik
Ik
Ik
Ik
Ik
Ik
Ik
Ik
Ik
Ik
Ik
vo
Wd
vd
vd
Sx
iI
Jk
Jk
Jk
Jk
Jk
Jk
Jk
Jk
Jk
Jk
Jk
Jk
Jk
Jk
iI
UL
"}
(11,1,1) = {"
UL
vo
Ik
Ik
Ik
Ik
Ik
Ik
Ik
Ik
Ik
Ik
Ik
Ik
Ik
vo
Wd
vd
vd
Sx
iI
Jk
Jk
Jk
Jk
Jk
Jk
Jk
Jk
Jk
Jk
Jk
Jk
Jk
Jk
iI
UL
"}
(12,1,1) = {"
UL
vo
Ik
Ik
Ik
Ik
Ik
Ik
Ik
Ik
Ik
Ik
Ik
Ik
Ik
vo
Wd
vd
vd
Sx
iI
Jk
Jk
Jk
Jk
Jk
Jk
Jk
Jk
Jk
Jk
Jk
Jk
Jk
Jk
iI
UL
"}
(13,1,1) = {"
UL
vo
Ik
Ik
Ik
Ik
Ik
Ik
Ik
Ik
Ik
Ik
Ik
Ik
Ik
vo
NJ
vd
vd
Wn
iI
Jk
Jk
Jk
Jk
Jk
Jk
Jk
Jk
Jk
Jk
Jk
Jk
Jk
Jk
iI
UL
"}
(14,1,1) = {"
UL
vo
Ik
Ik
Ik
Ik
Ik
Ik
Ik
Ik
Ik
Ik
Ik
Ik
iA
iA
iA
tc
tc
iA
iA
iA
Jk
Jk
Jk
Jk
Jk
Jk
Jk
Jk
Jk
Jk
Jk
Jk
Jk
iI
UL
"}
(15,1,1) = {"
UL
vo
Ik
Ik
Ik
Ik
Ik
Ik
Ik
Ik
Ik
Ik
Ik
iA
lr
ue
lt
GS
GS
lt
Kt
ZD
iA
Jk
Jk
Jk
Jk
Jk
Jk
Jk
Jk
Jk
Jk
Jk
Jk
iI
UL
"}
(16,1,1) = {"
UL
vo
Ik
Ik
Ik
Ik
Ik
Ik
Ik
Ik
Ik
Ik
iA
lr
ue
fK
AN
GS
GS
jK
TM
Kt
ZD
iA
Jk
Jk
Jk
Jk
Jk
Jk
Jk
Jk
Jk
Jk
Jk
iI
UL
"}
(17,1,1) = {"
UL
vo
vo
vo
vo
vo
vo
vo
vo
vo
vo
vo
iA
ue
fK
AN
dp
km
be
GS
jK
TM
Kt
iA
iI
iI
iI
iI
Fs
Fs
iI
iI
iI
iI
iI
iI
UL
"}
(18,1,1) = {"
UL
bT
vd
vd
vd
vd
vd
vd
vd
vd
vd
iT
gP
ub
of
XC
ct
yn
lR
sX
GS
GS
GS
gP
iT
vd
vd
vd
vd
vd
vd
vd
vd
vd
Qs
XR
UL
"}
(19,1,1) = {"
UL
Sj
vd
vd
vd
vd
vd
vd
vd
vd
vd
vd
PI
GS
gJ
GS
ct
fH
Zc
oD
GS
GS
GS
uG
vd
vd
vd
vd
vd
vd
vd
vd
vd
vd
vd
to
Cp
"}
(20,1,1) = {"
UL
XO
vd
Gg
vd
vd
vd
vd
vd
vd
vd
CN
gP
hE
OM
OK
ct
sy
Lf
uc
GS
GS
GS
gP
CN
vd
vd
vd
vd
vd
vd
vd
vd
vd
vd
hL
UL
"}
(21,1,1) = {"
UL
vC
vC
vC
vC
vC
vC
vC
vC
vC
vC
vC
iA
bo
hC
aR
dp
dH
be
GS
pR
bX
MV
iA
fu
fu
fu
fu
fu
fu
fu
fu
fu
fu
fu
fu
UL
"}
(22,1,1) = {"
UL
vC
Lz
Lz
Lz
Lz
Lz
Lz
Lz
Lz
Lz
Lz
iA
qQ
if
hC
aR
GS
GS
pR
bX
MV
RE
iA
eG
eG
eG
eG
eG
eG
eG
eG
eG
eG
eG
fu
UL
"}
(23,1,1) = {"
UL
vC
Lz
Lz
Lz
Lz
Lz
Lz
Lz
Lz
Lz
Lz
Lz
iA
qQ
bo
jP
GS
GS
jP
MV
RE
iA
eG
eG
eG
eG
eG
eG
eG
eG
eG
eG
eG
eG
fu
UL
"}
(24,1,1) = {"
UL
vC
Lz
Lz
Lz
Lz
Lz
Lz
Lz
WW
Hn
iX
Lz
Lz
iA
iA
iA
tc
tc
iA
iA
iA
eG
eG
eG
eG
eG
eG
eG
eG
eG
eG
eG
eG
eG
fu
UL
"}
(25,1,1) = {"
UL
vC
Lz
Lz
Lz
Lz
Lz
Lz
Lz
EQ
XU
VA
Lz
Lz
Lz
vC
NJ
vd
vd
NJ
fu
eG
eG
eG
eG
eG
eG
eG
eG
eG
eG
eG
eG
eG
eG
fu
UL
"}
(26,1,1) = {"
UL
vC
Lz
Lz
Lz
Lz
Lz
Lz
Lz
qE
Hd
JP
Lz
Lz
Lz
vC
Wd
vd
vd
Wd
fu
eG
eG
eG
eG
eG
eG
eG
eG
dR
eG
eG
eG
eG
eG
fu
UL
"}
(27,1,1) = {"
UL
vC
Lz
Lz
Lz
Lz
Lz
Lz
Lz
Lz
Lz
Lz
Lz
Lz
Lz
vC
Wd
vd
vd
Wd
fu
eG
eG
eG
eG
eG
eG
eG
eG
eG
eG
eG
eG
eG
eG
fu
UL
"}
(28,1,1) = {"
UL
vC
Lz
Lz
Lz
Lz
Lz
Lz
Lz
Lz
Lz
Lz
Lz
Lz
Lz
vC
Wd
vd
vd
Wd
fu
eG
eG
eG
eG
eG
eG
eG
eG
eG
eG
eG
eG
eG
eG
fu
UL
"}
(29,1,1) = {"
UL
vC
Lz
Lz
Lz
Lz
Lz
Lz
Lz
Lz
Lz
Lz
Lz
Lz
Lz
vC
Wd
vd
vd
Wd
fu
eG
eG
eG
eG
eG
eG
eG
eG
eG
eG
eG
eG
eG
eG
fu
UL
"}
(30,1,1) = {"
UL
vC
Lz
Lz
Lz
Lz
Lz
Lz
Lz
Lz
Lz
Lz
Lz
Lz
Lz
vC
Wd
vd
vd
Wd
fu
eG
eG
eG
eG
eG
eG
eG
eG
eG
eG
eG
eG
eG
eG
fu
UL
"}
(31,1,1) = {"
UL
vC
Lz
Lz
Lz
Lz
Lz
Lz
Lz
Lz
Lz
Lz
Lz
Lz
Lz
vC
Wd
vd
vd
Wd
fu
eG
eG
eG
eG
eG
eG
eG
eG
eG
eG
eG
eG
eG
eG
fu
UL
"}
(32,1,1) = {"
UL
vC
Lz
Lz
Lz
Lz
Lz
Lz
Lz
Lz
Lz
Lz
Lz
Lz
Lz
vC
Wd
vd
vd
Wd
fu
eG
eG
eG
eG
eG
eG
eG
eG
eG
eG
eG
eG
eG
eG
fu
UL
"}
(33,1,1) = {"
UL
vC
Lz
Lz
Lz
Lz
Lz
Lz
Lz
Lz
Lz
Lz
Lz
Lz
Lz
vC
Wd
vd
vd
Wd
fu
eG
eG
eG
eG
eG
eG
eG
eG
eG
eG
eG
eG
eG
eG
fu
UL
"}
(34,1,1) = {"
UL
vC
Lz
Lz
Lz
Lz
Lz
Lz
Lz
Lz
Lz
Lz
Lz
Lz
Lz
vC
Wd
vd
vd
Wd
fu
eG
eG
eG
eG
eG
eG
eG
eG
eG
eG
eG
eG
eG
eG
fu
UL
"}
(35,1,1) = {"
UL
vC
Lz
Lz
Lz
Lz
Lz
Lz
Lz
Lz
Lz
Lz
Lz
Lz
Lz
vC
Wd
vd
vd
Wd
fu
eG
eG
eG
eG
eG
eG
eG
eG
eG
eG
eG
eG
eG
eG
fu
UL
"}
(36,1,1) = {"
UL
vC
vC
vC
vC
vC
vC
vC
vC
vC
vC
vC
vC
vC
vC
vC
WK
WK
WK
WK
fu
fu
fu
fu
fu
fu
fu
fu
fu
fu
fu
fu
fu
fu
fu
fu
UL
"}
(37,1,1) = {"
UL
UL
UL
UL
UL
UL
UL
UL
UL
UL
UL
UL
UL
UL
UL
UL
UL
UL
UL
UL
UL
UL
UL
UL
UL
UL
UL
UL
UL
UL
UL
UL
UL
UL
UL
UL
UL
"}
